the	DT
be	VB
of	IN
and	CC
a	DT
to	TO
in	IN
he	PRP
have	VB
it	PRP
that	DT
for	IN
they	PRP
I	PRP
with	IN
as	RB
not	RB
on	IN
she	PRP
at	IN
by	IN
this	DT
we	PRP
you	PRP
do	VB
but	CC
from	IN
or	CC
which	WDT
one	CD
would	MD
all	DT
will	MD
there	RB
say	VB
who	WP
make	VB
when	WRB
can	MD
more	RBR
if	IN
no	DT
man	NN
out	RB
other	JJ
so	RB
what	WDT
time	NN
up	RB
go	VB
about	RB
than	IN
into	IN
could	MD
state	NN
only	RB
new	JJ
year	NN
some	DT
take	VB
come	VBN
these	DT
know	VB
see	VB
use	NN
get	VB
like	IN
then	RB
first	RB
any	DT
work	NN
now	RB
may	MD
such	JJ
give	VB
over	IN
think	VB
most	JJS
even	RB
find	VB
day	NN
also	RB
after	IN
way	NN
many	JJ
must	MD
look	NN
before	RB
great	JJ
back	RB
through	IN
long	RB
where	WRB
much	RB
should	MD
well	RB
people	NNS
down	RB
own	JJ
just	RB
because	RB
good	JJ
each	DT
those	DT
feel	VB
seem	VB
how	WRB
high	RB
too	RB
place	NN
little	RB
world	NN
very	RB
still	RB
nation	NN
hand	NN
old	JJ
life	NN
tell	VB
write	VB
become	VBN
here	RB
show	NN
house	NN
both	DT
between	IN
need	NN
mean	NN
call	NN
develop	VB
under	IN
last	JJ
right	RB
move	NN
thing	NN
general	JJ
school	NN
never	RB
same	JJ
another	DT
begin	VB
while	IN
number	NN
part	NN
turn	NN
real	RB
leave	NN
might	MD
want	VB
point	NN
form	NN
off	RB
child	NN
few	JJ
small	JJ
since	IN
against	IN
ask	VB
late	RB
home	NN
interest	NN
large	JJ
person	NN
end	NN
open	JJ
public	NN
follow	VB
during	IN
present	JJ
without	IN
again	RB
hold	NN
govern	VB
around	RB
possible	JJ
head	NN
consider	VB
word	NN
program	NN
problem	NN
however	RB
lead	NN
system	NN
set	VBN
order	NN
eye	NN
plan	NN
run	NN
keep	VB
face	NN
fact	NN
group	NN
play	NN
stand	VB
increase	NN
early	RB
course	NN
change	NN
help	NN
line	NN
city	NN
put	VBN
close	RB
case	NN
force	NN
meet	VB
once	RB
water	NN
upon	IN
war	NN
build	VB
hear	VB
light	NN
unite	VB
live	VB
every	DT
country	NN
bring	VB
center	NN
let	VB
side	NN
try	VB
provide	VB
continue	VB
name	NN
certain	JJ
power	NN
pay	NN
result	NN
question	NN
study	NN
woman	NN
member	NN
until	IN
far	RB
night	NN
always	RB
service	NN
away	RB
report	NN
something	NN
company	NN
week	NN
church	NN
toward	IN
start	NN
social	JJ
room	NN
figure	NN
nature	NN
though	RB
young	JJ
less	RBR
enough	RB
almost	RB
read	NN
include	VB
president	NN
nothing	NN
yet	RB
better	RB
big	JJ
boy	NN
cost	NN
business	NN
value	NN
second	JJ
why	WRB
clear	JJ
expect	VB
family	NN
complete	JJ
act	NN
sense	NN
mind	NN
experience	NN
art	NN
next	RB
near	IN
direct	JJ
car	NN
law	NN
industry	NN
important	JJ
girl	NN
god	NN
several	JJ
matter	NN
usual	JJ
rather	RB
per	IN
often	RB
kind	NN
among	IN
white	JJ
reason	NN
action	NN
return	NN
foot	NN
care	NN
simple	JJ
within	IN
love	NN
human	JJ
along	RB
appear	VB
doctor	NN
believe	VB
speak	VB
active	JJ
student	NN
month	NN
drive	NN
concern	NN
best	RB
door	NN
hope	NN
example	NN
inform	VB
body	NN
ever	RB
least	JJS
probable	JJ
understand	VB
reach	NN
effect	NN
different	JJ
idea	NN
whole	NN
control	NN
condition	NN
field	NN
pass	NN
fall	NN
note	NN
special	JJ
talk	NN
particular	JJ
today	NN
measure	NN
walk	NN
teach	VB
low	JJ
hour	NN
type	NN
carry	VB
rate	NN
remain	VB
full	JJ
street	NN
easy	RB
although	IN
record	NN
sit	VB
determine	VB
level	NN
local	JJ
sure	RB
receive	VB
thus	RB
moment	NN
spirit	NN
train	NN
college	NN
religion	NN
perhaps	RB
music	NN
grow	VB
free	JJ
cause	NN
serve	VB
age	NN
book	NN
board	NN
recent	JJ
sound	NN
office	NN
cut	NN
step	NN
class	NN
true	JJ
history	NN
position	NN
above	RB
strong	JJ
friend	NN
necessary	JJ
add	VB
court	NN
deal	NN
tax	NN
support	NN
party	NN
whether	IN
either	RB
land	NN
material	NN
happen	VB
education	NN
death	NN
agree	VB
arm	NN
mother	NN
across	IN
quite	RB
anything	NN
town	NN
past	NN
view	NN
society	NN
manage	VB
answer	NN
break	NN
organize	VB
half	NN
fire	NN
lose	VB
money	NN
stop	NN
actual	JJ
already	RB
effort	NN
wait	NN
department	NN
able	JJ
political	JJ
learn	VB
voice	NN
air	NN
together	RB
shall	MD
cover	NN
common	JJ
subject	NN
draw	NN
short	RB
wife	NN
treat	NN
limit	NN
road	NN
letter	NN
color	NN
behind	RB
produce	VB
send	VB
term	NN
total	NN
university	NN
rise	NN
century	NN
success	NN
minute	NN
remember	VB
purpose	NN
test	NN
fight	NN
watch	NN
situation	NN
south	RB
ago	RB
difference	NN
stage	NN
father	NN
table	NN
rest	NN
bear	NN
entire	JJ
market	NN
prepare	VB
explain	VB
offer	NN
plant	NN
charge	NN
ground	NN
west	NN
picture	NN
hard	RB
front	NN
lie	NN
modern	JJ
dark	JJ
surface	NN
rule	NN
regard	NN
dance	NN
peace	NN
observe	VB
future	NN
wall	NN
farm	NN
claim	NN
firm	NN
operation	NN
further	RB
pressure	NN
property	NN
morning	NN
amount	NN
top	NN
outside	RB
piece	NN
sometimes	RB
beauty	NN
trade	NN
fear	NN
demand	NN
wonder	NN
list	NN
accept	VB
judge	NN
paint	NN
mile	NN
soon	RB
responsible	JJ
allow	VB
secretary	NN
heart	NN
union	NN
slow	JJ
island	NN
enter	VB
drink	NN
story	NN
experiment	NN
stay	NN
paper	NN
space	NN
apply	VB
decide	VB
share	NN
desire	NN
spend	VB
sign	NN
therefore	RB
various	JJ
visit	NN
supply	NN
officer	NN
doubt	NN
private	JJ
immediate	JJ
wish	NN
contain	VB
feed	NN
raise	NN
describe	VB
ready	JJ
horse	NN
son	NN
exist	VB
north	RB
suggest	VB
station	NN
effective	JJ
food	NN
deep	RB
wide	JJ
alone	RB
character	NN
english	JJ
happy	JJ
critic	NN
unit	NN
product	NN
respect	NN
drop	NN
nor	CC
fill	NN
cold	JJ
represent	VB
sudden	JJ
basic	JJ
kill	NN
fine	NN
trouble	NN
mark	NN
single	JJ
press	NN
heavy	JJ
attempt	NN
origin	NN
standard	NN
everything	NN
committee	NN
moral	JJ
black	JJ
red	JJ
bad	JJ
earth	NN
accord	NN
else	RB
mere	JJ
die	VB
remark	NN
basis	NN
except	IN
equal	JJ
east	RB
event	NN
employ	VB
defense	NN
smile	NN
river	NN
improve	VB
game	NN
detail	NN
account	NN
cent	NN
sort	NN
reduce	VB
club	NN
buy	VB
attention	NN
ship	NN
decision	NN
wear	NN
inside	RB
win	VB
suppose	VB
ride	NN
operate	VB
realize	VB
sale	NN
choose	VB
park	NN
square	NN
vote	NN
price	NN
district	NN
dead	JJ
foreign	JJ
window	NN
beyond	IN
direction	NN
strike	NN
instead	RB
trial	NN
practice	NN
catch	NN
opportunity	NN
likely	RB
recognize	VB
permit	NN
serious	JJ
attack	NN
floor	NN
association	NN
spring	NN
lot	NN
stock	NN
lack	NN
hair	NN
science	NN
relation	NN
profession	NN
pattern	NN
quick	JJ
medical	JJ
influence	NN
occasion	NN
machine	NN
compare	VB
husband	NN
blue	JJ
international	JJ
fair	JJ
especially	RB
indeed	RB
imagine	VB
surprise	NN
average	NN
official	NN
temperature	NN
difficult	JJ
sing	VB
hit	NN
tree	NN
race	NN
police	NNS
touch	NN
relative	JJ
throw	VB
quality	NN
former	JJ
pull	NN
chance	NN
prove	VB
argue	VBP
settle	VB
growth	NN
date	NN
heat	NN
save	VB
performance	NN
count	NN
production	NN
listen	VB
main	JJ
pick	NN
size	NN
cool	NN
army	NN
patient	NN
combine	VB
summer	NN
hall	NN
slight	JJ
command	NN
enjoy	VB
length	NN
proper	JJ
express	VB
health	NN
chief	NN
evening	NN
store	NN
language	NN
degree	NN
lay	JJ
current	JJ
gun	NN
dog	NN
hotel	NN
strange	JJ
separate	JJ
boat	NN
fail	VB
clean	JJ
dress	NN
anyone	NN
gain	NN
pain	NN
object	NN
knowledge	NN
depend	VB
relate	VB
below	IN
dollar	NN
advance	NN
shape	NN
arrange	VB
population	NN
yes	RB
sell	NN
mention	NN
dry	JJ
check	NN
poet	NN
sleep	NN
join	VB
hot	JJ
bed	NN
electric	JJ
dream	NN
due	RB
season	NN
manner	NN
fit	NN
left	RB
progress	NN
neither	DT
strength	NN
notice	NN
finish	NN
opinion	NN
bill	NN
western	JJ
truth	NN
wrong	JJ
travel	NN
suit	NN
bank	NN
exact	JJ
honor	NN
brother	NN
quiet	JJ
marry	VB
corner	NN
handle	VB
danger	NN
hospital	NN
pool	NN
promise	NN
blood	NN
shoot	NN
scene	NN
literature	NN
arrive	VB
film	NN
base	NN
freedom	NN
bar	NN
maybe	RB
hang	VB
suffer	VB
manufacture	NN
frequent	JJ
rock	NN
loss	NN
burn	VB
sun	NN
audience	NN
essential	JJ
glass	NN
prevent	VB
poem	NN
poor	JJ
inch	NN
song	NN
skill	NN
post	NN
popular	JJ
radio	NN
animal	NN
conscious	JJ
worth	NN
eat	VB
election	NN
faith	NN
wave	NN
murder	NN
model	NN
forget	VB
extend	VB
edge	NN
distance	NN
memory	NN
recommend	VB
division	NN
staff	NN
leg	NN
discussion	NN
address	NN
fly	NN
dependent	JJ
ball	NN
shake	NN
frame	NN
extreme	JJ
engineer	NN
thick	JJ
comfort	NN
latter	JJ
camp	NN
oil	NN
discover	VB
examine	VB
difficulty	NN
tooth	NN
middle	NN
choice	NN
refer	VB
enemy	NN
practical	JJ
marriage	NN
bridge	NN
declare	VB
lady	NN
cross	NN
daily	RB
afternoon	NN
attend	VB
director	NN
balance	NN
wash	NN
capital	NN
speed	NN
block	NN
citizen	NN
mouth	NN
hill	NN
green	JJ
please	VB
motor	NN
agency	NN
encourage	VB
governor	NN
worry	NN
affair	NN
shoulder	NN
bright	JJ
mass	NN
sample	NN
pretty	RB
repeat	NN
roll	NN
push	NN
trip	NN
council	NN
clothe	VB
parent	NN
forward	RB
sharp	JJ
straight	RB
gas	NN
weight	NN
discuss	VB
fix	NN
load	NN
master	NN
whatever	WDT
round	NN
rapid	JJ
laugh	NN
finger	NN
spot	NN
propose	VBP
shop	NN
broad	JJ
replace	VB
reply	NN
extent	NN
lock	NN
employee	NN
ahead	RB
sight	NN
spread	NN
wind	NN
approve	VB
destroy	VB
none	NN
pound	NN
fame	NN
importance	NN
reflect	VB
advantage	NN
match	NN
regular	JJ
wage	NN
refuse	NN
existence	NN
hardly	RB
perform	VB
title	NN
tend	VB
exercise	NN
thin	JJ
coat	NN
bit	NN
mountain	NN
youth	NN
behavior	NN
newspaper	NN
secret	NN
ability	NN
sea	NN
soft	JJ
justice	NN
reasonable	JJ
circle	NN
solid	JJ
page	NN
weapon	NN
fast	RB
representative	NN
search	NN
pure	JJ
escape	NN
crowd	NN
stick	NN
telephone	NN
avoid	VB
garden	NN
favor	NN
news	NN
unless	IN
dinner	NN
someone	NN
signal	NN
yard	NN
ideal	NN
warm	JJ
miss	VB
shelter	NN
soldier	NN
article	NN
cry	NN
captain	NN
familiar	JJ
seat	NN
guest	NN
weak	JJ
excite	NN
king	NN
everyone	NN
wine	NN
hole	NN
duty	NN
beat	NN
perfect	JJ
bottom	NN
compose	VB
battle	NN
expense	NN
cattle	NNS
flow	NN
kitchen	NN
dust	NN
bottle	NN
admit	VB
tear	VB
tire	NN
expression	NN
exception	NN
application	NN
belong	VB
rich	JJ
failure	NN
struggle	NN
instrument	NN
variety	NN
narrow	JJ
theater	NN
collection	NN
rain	NN
review	NN
preserve	VB
leadership	NN
clay	NN
daughter	NN
fellow	NN
swing	NN
thank	VB
library	NN
fat	NN
reserve	NN
tour	NN
nice	JJ
warn	VB
ring	NN
bitter	JJ
chair	NN
yesterday	NN
scientific	JJ
flower	NN
wheel	NN
solution	NN
aim	NN
gather	VB
invite	VB
moreover	RB
fresh	JJ
forest	NN
winter	NN
box	NN
belief	NN
ordinary	JJ
impossible	JJ
print	NN
gray	JJ
taste	NN
lip	NN
speech	NN
reference	NN
stain	VB
connection	NN
otherwise	RB
stretch	NN
knife	NN
village	NN
blow	NN
mistake	NN
sweet	JJ
shout	NN
divide	NN
guard	NN
worse	JJR
exchange	NN
rare	JJ
commercial	JJ
request	NN
appoint	VB
agent	NN
dependence	NN
bird	NN
wild	JJ
motion	NN
guess	NN
neighbor	NN
seed	NN
fashion	NN
loan	NN
correct	JJ
plain	RB
mail	NN
retire	VB
opposite	JJ
prefer	VBP
safe	JJ
evil	NN
double	RB
wood	NN
empty	JJ
baby	NN
advise	VB
content	NN
sport	NN
lift	NN
literary	JJ
curious	JJ
tie	NN
flat	JJ
message	NN
neck	NN
hate	NN
dirt	NN
delight	NN
trust	NN
nobody	NN
valley	NN
tool	NN
presence	NN
cook	NN
railroad	NN
minister	NN
coffee	NN
brush	NN
beside	RB
collect	VB
guide	NN
luck	NN
profit	NN
lord	NN
everybody	NN
prison	NN
cloud	NN
slave	NN
chairman	NN
soil	NN
distinguish	VB
introduce	VB
urge	NN
blind	JJ
arise	VB
upper	JJ
curve	NN
membership	NN
key	NN
entertain	VB
soul	NN
neighborhood	NN
friendly	JJ
pair	NN
stone	NN
lean	JJ
protect	VB
advertise	VB
mystery	NN
welcome	JJ
knee	NN
jump	NN
snake	NN
stream	NN
avenue	NN
brown	JJ
disease	NN
hat	NN
excellent	JJ
formal	JJ
snow	NN
sheet	NN
somehow	RB
unity	NN
sky	NN
rough	JJ
smooth	NN
weather	NN
steady	RB
threaten	VB
depth	NN
oppose	VBP
deliver	VB
ancient	JJ
pray	NN
adopt	VB
birth	NN
appearance	NN
universe	NN
busy	JJ
hurry	NN
coast	NN
forth	RB
smell	NN
furnish	VB
female	NN
hide	VB
wire	NN
proposal	NN
ought	MD
victory	NN
quarter	NN
engine	NN
customer	NN
waste	NN
fool	NN
intend	VB
intention	NN
desk	NN
politics	NNS
passage	NN
lawyer	NN
root	NN
climb	NN
metal	NN
gradual	JJ
hunt	NN
protection	NN
satisfy	VB
roof	NN
branch	NN
pleasure	NN
witness	NN
loose	RB
nose	NN
mine	NN
band	NN
aside	RB
risk	NN
tomorrow	NN
remind	VB
ear	NN
fish	NN
shore	NN
operator	NN
civilize	VB
being	VBG
silent	JJ
screen	NN
bind	NN
earn	VB
pack	NN
colony	NN
besides	IN
slip	NN
cousin	NN
scale	NN
relief	NN
explore	VB
stem	NN
brain	NN
musician	NN
defend	VB
bend	NN
somebody	NN
shadow	NN
mix	NN
smoke	NN
description	NN
fruit	NN
guilt	NN
yield	NN
sensitive	JJ
salt	NN
pale	NN
sweep	NN
completion	NN
throat	NN
agriculture	NN
admire	NN
gentle	JJ
dozen	NN
particle	NN
pleasant	JJ
bay	NN
cup	NN
competition	NN
moon	NN
terrible	JJ
strip	NN
mechanic	NN
shock	NN
conversation	NN
angle	NN
tall	JJ
plenty	RB
star	NN
yellow	JJ
sick	JJ
thorough	JJ
absolute	JJ
succeed	VB
surround	VB
proud	NN
dear	RB
card	NN
lake	NN
breath	NN
afraid	JJ
silence	NN
onto	IN
shoe	NN
somewhere	RB
chain	NN
slide	NN
copy	NN
machinery	NN
wake	NN
severe	JJ
pocket	NN
bone	NN
honest	JJ
freeze	NN
dictionary	NN
calm	NN
swim	VBP
ice	NN
male	NN
skin	NN
crack	NN
rush	NN
wet	JJ
meat	NN
commerce	NN
joint	NN
gift	NN
host	NN
suspect	NN
path	NN
uncle	NN
afford	VB
instant	NN
satisfactory	JJ
height	NN
track	NN
confidence	NN
grass	NN
suggestion	NN
favorite	JJ
breakfast	NN
apart	RB
chest	NN
entrance	NN
march	NN
sink	NN
northern	JJ
iron	NN
alive	JJ
ill	RB
bag	NN
disturb	VB
native	JJ
bedroom	NN
violent	JJ
beneath	IN
pause	NN
tough	JJ
substance	NN
threat	NN
charm	NN
absence	NN
factory	NN
spite	NN
meal	NN
universal	JJ
accident	NN
highway	NN
sentence	NN
liberty	NN
wise	JJ
noise	NN
discovery	NN
tube	NN
flash	NN
twist	NN
fence	NN
childhood	NN
joy	NN
sister	NN
sad	JJ
efficiency	NN
disappear	VB
defeat	NN
extensive	JJ
rent	NN
comparison	NN
possess	VB
grace	NN
flesh	NN
liquid	NN
scientist	NN
ease	NN
heaven	NN
milk	NN
sympathy	NN
rank	NN
restaurant	NN
frequency	NN
angry	JJ
shade	NN
accuse	VB
necessity	NN
knock	VB
loud	RB
permanent	JJ
row	NN
lovely	JJ
confuse	VB
gold	NN
frighten	NN
solve	VB
grave	NN
salary	NN
photograph	NN
advice	NN
abroad	RB
wound	NN
virtue	NN
dare	VB
queen	NN
extra	JJ
attract	VB
numerous	JJ
pink	NN
gate	NN
expensive	JJ
shut	VBN
chicken	NN
forgive	VB
holy	JJ
wooden	JJ
prompt	JJ
crime	NN
sorry	RB
republic	NN
anger	NN
visitor	NN
pile	NN
violence	NN
steel	NN
wing	NN
stair	NN
partner	NN
delay	NN
gentleman	NN
pour	VBP
confusion	NN
damage	NN
kick	NN
safety	NN
burst	NN
network	NN
resistance	NN
screw	NN
pride	NN
till	IN
hire	NN
verb	VB
preach	VB
clerk	NN
everywhere	RB
anyway	RB
fan	NN
connect	VB
egg	NN
efficient	JJ
grain	NN
calculate	VB
drag	NN
opposition	NN
worship	NN
arrest	NN
discipline	NN
string	NN
harbor	NN
camera	NN
mechanism	NN
cow	NN
grand	JJ
funny	JJ
insurance	NN
reduction	NN
strict	JJ
lesson	NN
tight	RB
sand	NN
plate	NN
qualify	VB
elsewhere	RB
mad	JJ
interference	NN
pupil	NN
fold	NN
royal	NN
valuable	JJ
whisper	NN
anybody	NN
hurt	NN
excess	NN
quantity	NN
fun	NN
mud	NN
extension	NN
recognition	NN
kiss	NN
crop	NN
sail	NN
attractive	JJ
habit	NN
relieve	VB
wisdom	NN
persuade	VB
certainty	NN
cloth	NN
eager	JJ
deserve	VB
sympathetic	JJ
cure	NN
trap	NN
puzzle	NN
powder	NN
raw	JJ
mankind	NN
glad	JJ
blame	NN
whenever	WRB
anxiety	NN
bus	NN
tremble	VB
sacred	JJ
fortunate	JJ
glory	NN
golden	JJ
neat	JJ
weekend	NN
treasury	NN
overcome	VBN
cat	NN
sacrifice	NN
complain	VB
elect	VB
roar	NN
sake	NN
temple	NN
self	NN
compete	VB
nurse	NN
stuff	NN
stomach	NN
peculiar	JJ
repair	NN
storm	NN
ton	NN
desert	NN
allowance	NN
servant	NN
hunger	NN
conscience	NN
bread	NN
crash	NN
tip	NN
strengthen	VB
proof	NN
generous	JJ
sir	NN
tonight	RB
whip	NN
tongue	NN
mill	NN
merchant	NN
coal	NN
ruin	VB
introduction	NN
courage	NN
actor	NN
belt	NN
stir	VB
package	NN
punish	VB
reflection	NN
breathe	VB
anywhere	RB
amuse	VB
dull	JJ
fate	NN
net	NN
fellowship	NN
fault	NN
furniture	NN
beam	NN
pencil	NN
border	NN
disappoint	VB
flame	NN
joke	NN
bless	VB
corn	NN
shell	NN
tempt	VB
supper	NN
destruction	NN
dive	NN
anxious	JJ
shine	NN
cheap	RB
dish	NN
distant	JJ
greet	VB
flood	NN
excuse	NN
insect	NN
ocean	NN
ceremony	NN
decrease	NN
prize	NN
harm	NN
insure	VB
verse	NN
pot	NN
sincere	JJ
cotton	NN
leaf	NN
rub	NN
medicine	NN
stroke	NN
bite	NN
lung	NN
lonely	JJ
admission	NN
stupid	JJ
scratch	NN
composition	NN
broadcast	NN
drum	VB
resist	VB
neglect	NN
absent	JJ
passenger	NN
adventure	NN
beg	VB
pipe	NN
beard	NN
bold	JJ
meanwhile	RB
devil	NNP
cheer	NN
nut	NN
split	NN
melt	VB
swear	VB
sugar	NN
bury	VB
wipe	VB
faint	JJ
creature	NN
tail	NN
wealth	NN
earnest	NN
translate	VB
suspicion	NN
noble	JJ
inquiry	NN
journey	NN
hesitate	VB
extraordinary	JJ
borrow	VB
owe	VB
funeral	NN
ambition	NN
mixture	NN
slope	NN
criminal	JJ
seldom	RB
map	NN
spin	NN
praise	NN
spare	JJ
plow	VB
telegraph	NN
barrel	NN
straighten	VB
scarce	JJ
lunch	NN
slavery	NN
creep	NN
sweat	NN
gay	JJ
stiff	JJ
brave	VB
seize	VB
convenient	JJ
horizon	NN
moderate	JJ
complicate	VB
dig	NN
curse	NN
weigh	VB
priest	NN
excessive	JJ
quarrel	VB
widow	NN
modest	JJ
dine	VB
politician	NN
custom	NN
educate	VB
salesman	NN
nail	NN
tap	NN
eastern	JJ
possession	NN
satisfaction	NN
behave	VB
mercy	NN
scatter	NN
objection	NN
silver	NN
tent	NN
saddle	NN
wrap	NN
nest	NN
grind	NN
spell	NN
plaster	NN
arch	NN
swell	NN
friendship	NN
bath	NN
bundle	NN
grateful	JJ
crown	NN
boundary	NN
nowhere	RB
asleep	RB
clock	NN
boil	NN
altogether	RB
lend	VB
holiday	NN
precious	JJ
wander	VB
ugly	JJ
reputation	NN
ticket	NN
pretend	JJ
dismiss	VB
delicate	JJ
despair	NN
awake	RB
tea	NN
FALSE	NN
fortune	NN
cap	NN
thread	NN
haste	NN
bare	JJ
shirt	NN
bargain	NN
leather	NN
rail	NN
butter	NN
dot	NN
inquire	NN
warmth	NN
decisive	JJ
vessel	NN
pity	NN
steam	NN
pin	NN
bound	VBN
companion	NN
toe	NN
reward	NN
forbid	NN
wherever	WRB
tower	NN
bathe	VB
lodge	VB
swallow	VB
multiply	VB
bow	NN
kingdom	NN
garage	NN
permission	NN
pump	NN
prevention	NN
urgent	JJ
aunt	NN
zero	CD
idle	JJ
fever	NN
christmas	NNS
regret	NN
jaw	NN
soap	NN
pronounce	VB
empire	NN
bowl	NN
outline	NN
organ	NN
imitation	NN
caution	NN
mineral	NN
disagree	VB
blade	NN
trick	NN
treasure	NN
immense	JJ
convenience	NN
disapprove	VB
destructive	JJ
fork	NN
noon	NN
ownership	NN
tune	NN
polish	NN
poison	NN
shame	NN
loyalty	NN
cottage	NN
astonish	VB
shave	VB
feather	NN
sauce	NN
lid	NN
debt	NN
fade	VB
confess	NN
classification	NN
descend	NN
cape	NN
mild	JJ
clever	JJ
envelope	NN
invention	NN
sheep	NN
splendid	JJ
stamp	NN
float	NN
brick	NN
rice	NN
businessman	NN
backward	RB
qualification	NN
artificial	JJ
attraction	NN
lamp	NN
curl	VB
shower	NN
elder	JJR
bunch	NN
bell	NN
steer	VB
flavor	NN
spit	NN
rob	NN
cream	NN
interrupt	VB
pen	NN
weave	VB
orange	NN
rescue	NN
crush	NN
humble	JJ
fancy	NN
decay	NN
polite	JJ
tribe	NN
bleed	VB
coin	NN
fond	JJ
autumn	NN
classify	VB
omit	VB
loyal	JJ
needle	NN
lessen	VB
complaint	NN
pad	NN
steep	JJ
skirt	NN
curtain	NN
calculation	NN
laughter	NN
solemn	JJ
grease	NN
interfere	VB
explode	VB
fasten	NN
flag	NN
resign	VB
postpone	VB
patience	NN
boast	NN
rope	NN
envy	NN
airplane	NN
rid	JJ
shield	NN
veil	NN
kneel	NN
tray	NN
explosive	NN
brass	NN
taxi	NN
wax	NN
duck	NN
button	NN
invent	VB
remedy	NN
bush	NN
thunder	NN
weaken	VB
poverty	NN
scrape	NN
arrow	NN
tender	NN
cruel	JJ
soften	VB
mouse	NN
hay	NN
anyhow	RB
alike	RB
circular	JJ
juice	NN
shelf	NN
bake	NN
hatred	NN
cautious	JJ
basket	NN
wreck	NN
width	NN
confident	JJ
log	NN
heap	NN
suck	NN
ladder	NN
gap	NN
obey	NN
hut	NN
axe	NN
translation	NN
collar	NN
delivery	NN
reproduce	VB
confession	NN
pan	NN
prejudice	NN
voyage	NN
tobacco	NN
simplicity	NN
paste	VB
cake	NN
elephant	NN
ribbon	NN
harvest	NN
ashamed	JJ
cave	NN
customary	JJ
thief	NN
damp	VB
sew	VB
rust	NN
separation	NN
waiter	NN
pet	NN
straw	NN
upset	NN
towel	NN
refresh	VB
essence	NN
fur	NN
ambitious	JJ
defendant	NN
daylight	NN
dip	NN
suspicious	JJ
imaginary	JJ
ash	JJ
carriage	NN
educator	NN
saw	NN
stove	NN
rubber	NN
rug	NN
misery	NN
awkward	JJ
rival	NN
roast	NN
deed	NN
preference	NN
explosion	NN
theatrical	NN
cultivate	NN
collector	NN
miserable	JJ
wrist	NN
rabbit	NN
accustom	NN
tide	NN
insult	NN
thumb	NN
lump	NN
annoy	NN
toy	NN
heal	VB
shallow	JJ
repetition	NN
soup	NN
whistle	VB
scenery	NN
apple	NN
offense	NN
cork	NN
ripe	JJ
temper	NN
sore	JJ
pinch	NN
diamond	NN
razor	NN
imaginative	JJ
hook	NN
copper	NN
landlord	NN
influential	JJ
rot	NN
hollow	JJ
enclose	VB
harden	NN
wicked	JJ
stiffen	VB
silk	NN
upright	NN
selfish	JJ
stripe	NN
pig	NN
inward	JJ
excellence	NN
rake	NN
purple	JJ
hasten	VB
shorten	VB
applause	NN
ache	NN
apology	NN
knot	NN
nephew	NN
cushion	NN
drown	VB
nursery	NN
pint	NN
fierce	JJ
imitate	VB
aloud	RB
gaiety	NN
robbery	NN
tighten	VB
perfection	NN
scorn	VB
whoever	WP
trunk	NN
wool	NN
sailor	NN
competitor	NN
moonlight	NN
deer	NNS
bean	NN
everyday	JJ
drawer	NN
disregard	NN
nowadays	RB
patriotic	JJ
tin	NN
penny	NN
cage	NN
pardon	NN
lately	RB
offend	VB
coarse	JJ
spoil	VB
horizontal	JJ
sting	NN
ditch	NN
librarian	NN
meantime	NN
cough	NN
deaf	JJ
sword	NN
messenger	NN
vain	JJ
castle	NN
elastic	JJ
comb	NN
rod	NN
widen	VB
sorrow	NN
inventor	NN
cliff	NN
umbrella	NN
interruption	NN
merry	NN
gallon	NN
conquest	NN
headache	NN
tailor	NN
bucket	NN
scent	NN
signature	NN
cart	NN
darken	VB
sometime	RB
applaud	VB
underneath	IN
hello	UH
pretense	NN
descent	NN
conquer	VB
framework	NN
confidential	JJ
adoption	NN
disgust	NN
waist	NN
momentary	JJ
receipt	NN
pearl	NN
ray	NN
lazy	JJ
limb	NN
grammatical	JJ
beast	NN
monkey	NN
jewel	NN
persuasion	NN
obedience	NN
sock	NN
vowel	NN
hammer	NN
inn	NN
chimney	NN
dissatisfaction	NN
annoyance	NN
ornament	NN
honesty	NN
outward	JJ
sharpen	VB
handkerchief	NN
greed	NN
heavenly	RB
thirst	NN
niece	NN
spill	NN
loaf	NN
wheat	NN
worm	NN
secrecy	NN
rude	JJ
heighten	VB
flatten	VB
loosen	VB
cheese	NN
rivalry	NN
royalty	NN
discontent	NN
complication	NN
fright	NN
indoor	JJ
flour	NN
actress	NN
congratulation	NN
ounce	NN
fry	NN
everlasting	JJ
goat	NN
ink	NN
disappearance	NN
reproduction	NN
thicken	VB
avoidance	NN
spoon	NN
strap	NN
deceive	VB
lengthen	VB
revenge	NN
correction	NN
descendant	NN
hesitation	NN
spade	NN
basin	NN
weed	NN
omission	NN
old-fashioned	JJ
bicycle	NN
breadth	NN
photography	NN
coward	NN
mat	NN
rejoice	VB
cheat	VB
congratulate	VB
discomfort	NN
enclosure	NN
attentive	JJ
paw	NN
overflow	NN
dissatisfy	NN
multiplication	NN
whichever	WDT
tidy	JJ
bribe	NN
mend	VB
stocking	VBG
feast	NN
nuisance	NN
thorn	NN
tame	JJ
inclusive	JJ
homemade	NN
handwriting	NN
chalk	NN
sour	JJ
slippery	JJ
procession	NN
ripen	VB
jealous	JJ
jealousy	NN
liar	NN
homecoming	NN
barber	NN
whiten	NN
berry	NN
lighten	VB
pigeon	NN
hinder	VB
bravery	NN
baggage	NN
noun	NN
amongst	IN
grammar	NN
cultivation	NN
companionship	NN
rubbish	JJ
modesty	NN
woolen	NN
deepen	VB
pastry	NN
cupboard	NN
quart	NN
canal	NN
notebook	NN
deceit	NN
parcel	NN
brighten	NN
moderation	NN
punctual	JJ
hurrah	NN
lipstick	NN
uppermost	NN
fatten	VB
conqueror	NN
hindrance	NN
cowardice	NN
obedient	JJ
saucer	NN
madden	NN
scold	NN
weekday	NN
rotten	JJ
disrespect	NN
widower	NN
deafen	VB
donkey	NN
businesslike	JJ
motherhood	NN
sadden	VB
handshake	NN
calculator	NN
headdress	NN
scissors	NNS
translator	NN
possessor	NN
shilling	NN
redden	NN
motherly	JJ
whose	WP$
cultivator	NN
whom	WP
homework	NN
electrician	NN
oar	NN
bribery	NN
sweeten	VB
sow	VB
pronunciation	NN
beak	NN
plural	NN
