abandoned 	VBN 
abandon 	VBP 
ability 	NN 
able 	JJ 
about 	IN 
about 	RB 
above 	IN 
above 	RB 
abroad 	RB 
absence 	NN 
absent 	JJ 
absolute 	JJ 
absolutely 	RB 
absorb 	VB 
abuse 	NN 
academic 	JJ 
accent 	NN 
acceptable 	JJ 
accept 	VB 
access 	NN 
accidental 	JJ 
accidentally 	RB 
accident 	NN 
accompany 	VBP 
according 	VBG 
account 	NN 
accurate 	JJ 
accurately 	RB 
accuse 	VBP 
achievement 	NN 
achieve 	VB 
acid 	NN 
acknowledge 	VBP 
acquire 	NN 
across 	IN 
action 	NN 
active 	JJ 
actively 	RB 
activist 	JJ 
activity 	NN 
actor 	NN 
actress 	NN 
actual 	JJ 
actually 	RB 
act 	VBP 
adapt 	VB 
additional 	JJ 
addition 	NN 
address 	NN 
add 	VBP 
adequate 	JJ 
adequately 	RB 
adjust 	VBP 
administration 	NN 
admiration 	NN 
admire 	VBP 
admit 	VB 
ad 	NN 
adopt 	VB 
a 	DT 
adult 	JJ 
advanced 	JJ 
advance 	NN 
advantage 	NN 
adventure 	NN 
advertisement 	NN 
advertise 	VB 
advertising 	NN 
advice 	NN 
advise 	VBP 
affair 	NN 
affection 	NN 
affect 	VBP 
afford 	VB 
afraid 	JJ 
after 	IN 
afternoon 	NN 
afterward 	RB 
afterwards 	RB 
again 	RB 
against 	IN 
aged 	JJ 
agency 	NN 
agenda 	NN 
age 	NN 
agent 	NN 
aggressive 	JJ 
ago 	IN 
agreement 	NN 
agree 	VBP 
ahead 	RB 
aid 	NN 
aim 	NN 
aircraft 	NN 
air 	NN 
airport 	NN 
alarmed 	VBD 
alarming 	JJ 
alarm 	NN 
alcoholic 	JJ 
alcohol 	NN 
alive 	JJ 
all 	DT 
allied 	VBN 
allow 	VBP 
ally 	NN 
almost 	RB 
alone 	RB 
along 	IN 
alongside 	IN 
aloud 	RB 
alphabetical 	JJ 
alphabetically 	RB 
alphabet 	NN 
already 	RB 
also 	RB 
alternative 	JJ 
alternatively 	RB 
alter 	VBP 
although 	IN 
altogether 	RB 
always 	RB 
amazed 	VBN 
amaze 	VB 
amazing 	JJ 
ambition 	NN 
ambulance 	NN 
among 	IN 
amount 	NN 
a.m. 	RB 
amused 	VBD 
amuse 	VB 
amusing 	JJ 
analysis 	NN 
analyze 	VBP 
ancient 	JJ 
and 	CC 
an 	DT 
anger 	NN 
angle 	NN 
angrily 	RB 
angry 	JJ 
animal 	NN 
ankle 	NN 
anniversary 	NN 
announcement 	NN 
announce 	VB 
annoyed 	JJ 
annoying 	JJ 
annoy 	JJ 
annual 	JJ 
annually 	RB 
another 	DT 
answer 	NN 
anticipate 	VBP 
anxiety 	NN 
anxious 	JJ 
anxiously 	RB 
anybody 	NN 
any 	DT 
anyone 	NN 
anything 	NN 
anyway 	RB 
anywhere 	RB 
apartment 	NN 
apart 	RB 
apologize 	VB 
apparent 	JJ 
apparently 	RB 
appeal 	NN 
appearance 	NN 
appear 	VBP 
apple 	NN 
application 	NN 
apply 	VB 
appointment 	NN 
appoint 	VB 
appreciate 	VB 
approach 	NN 
appropriate 	JJ 
approval 	NN 
approve 	VBP 
approving 	VBG 
approximate 	JJ 
approximately 	RB 
April 	NNP 
area 	NN 
argue 	VBP 
argument 	NN 
arise 	VB 
armed 	JJ 
arm 	NN 
arms 	NNS 
army 	NN 
around 	IN 
arrangement 	NN 
arrange 	VBP 
arrest 	NN 
arrival 	NN 
arrive 	VBP 
arrow 	NN 
article 	NN 
artificial 	JJ 
artificially 	RB 
artistic 	JJ 
artist 	NN 
art 	NN 
ashamed 	JJ 
aside 	RB 
as 	IN 
ask 	VB 
asleep 	JJ 
aspect 	NN 
assistance 	NN 
assistant 	NN 
assist 	VB 
associate 	JJ 
association 	NN 
assume 	VB 
assure 	VB 
at 	IN 
atmosphere 	NN 
atom 	NN 
attached 	VBN 
attach 	VBP 
attack 	NN 
attempted 	VBD 
attempt 	NN 
attend 	VB 
attention 	NN 
attitude 	NN 
attorney 	NN 
attraction 	NN 
attractive 	JJ 
attract 	VB 
audience 	NN 
August 	NNP 
aunt 	NN 
authority 	NN 
author 	NN 
automatically 	RB 
automatic 	JJ 
available 	JJ 
average 	JJ 
avoid 	VB 
awake 	JJ 
award 	NN 
aware 	JJ 
away 	RB 
awful 	JJ 
awkward 	JJ 
awkwardly 	RB 
baby 	NN 
background 	NN 
back 	RB 
backward 	RB 
backwards 	RB 
bacteria 	NNS 
bad 	JJ 
badly 	RB 
baggage 	NN 
bag 	NN 
bake 	NN 
balance 	NN 
ball 	NN 
bandage 	NN 
band 	NN 
bank 	NN 
ban 	NN 
barely 	RB 
bargain 	NN 
bar 	NN 
barrier 	NN 
baseball 	NN 
base 	NN 
basically 	RB 
basic 	JJ 
basis 	NN 
basketball 	NN 
bath 	NN 
bathroom 	NN 
battery 	NN 
battle 	NN 
bay 	NN 
beach 	NN 
beak 	NN 
beard 	NN 
bear 	NN 
beat 	JJ 
beat 	VBD 
beautiful 	JJ 
beautifully 	RB 
beauty 	NN 
because 	IN 
because 	RB 
become 	VBN 
bed 	NN 
bedroom 	NN 
beef 	NN 
beer 	NN 
before 	IN 
beginning 	VBG 
begin 	VB 
behalf 	NN 
behave 	VBP 
behavior 	NN 
behind 	IN 
belief 	NN 
believe 	VBP 
bell 	NN 
belong 	VBP 
below 	IN 
belt 	NN 
bend 	NN 
beneath 	IN 
benefit 	NN 
bent 	JJ 
beside 	RB 
best 	JJS 
bet 	NN 
better 	JJR 
bet 	VB 
between 	IN 
be 	VB 
beyond 	IN 
bicycle 	NN 
bid 	NN 
big 	JJ 
bike 	NN 
bill 	NN 
biology 	NN 
bird 	NN 
birthday 	NN 
birth 	NN 
bite 	NN 
bite 	VBP 
bit 	NN 
bitter 	JJ 
bitterly 	RB 
black 	JJ 
blade 	NN 
blame 	NN 
blank 	JJ 
blankly 	RB 
blind 	JJ 
block 	NN 
blonde 	JJ 
blond 	JJ 
blood 	NN 
blow 	NN 
blue 	JJ 
board 	NN 
boat 	NN 
body 	NN 
boil 	VB 
bomb 	NN 
bond 	NN 
bone 	NN 
book 	NN 
boot 	NN 
border 	NN 
bored 	VBN 
bore 	VBD 
boring 	JJ 
born 	VBN 
borrow 	VB 
boss 	NN 
both 	CC 
bother 	VBP 
bottle 	VBP 
bottom 	JJ 
bottom 	NN 
bound 	VBD 
bowl 	NN 
box 	NN 
boyfriend 	NN 
boy 	NN 
brain 	NN 
branch 	NN 
brand 	NN 
brave 	VBP 
bread 	NN 
breakfast 	NN 
break 	NN 
breast 	NN 
breathe 	VBP 
breathing 	NN 
breath 	NN 
breed 	NN 
brick 	NN 
bridge 	NN 
brief 	JJ 
briefly 	NN 
bright 	JJ 
brightly 	RB 
brilliant 	JJ 
bring 	VBP 
broadcast 	NN 
broad 	JJ 
broadly 	RB 
broken 	JJ 
brother 	NN 
brown 	JJ 
brush 	NN 
bubble 	NN 
budget 	NN 
building 	NN 
build 	VBP 
bullet 	NN 
bunch 	NN 
burn 	VBP 
burst 	NN 
bury 	VB 
bush 	JJ 
businessman 	NN 
business 	NN 
businesswoman 	NN 
bus 	NN 
busy 	JJ 
but 	CC 
butter 	NN 
butt 	NN 
button 	NN 
buyer 	NN 
buy 	NN 
bye 	NN 
by 	IN 
cabinet 	NN 
cable 	NN 
cake 	NN 
calculate 	VBP 
calculation 	NN 
call 	NN 
calm 	JJ 
calmly 	RB 
camera 	NN 
campaign 	NN 
camp 	NN 
cancel 	VB 
cancer 	NN 
candidate 	NN 
candy 	NN 
can 	MD 
capable 	JJ 
capacity 	NN 
capital 	NN 
cap 	NN 
captain 	NN 
capture 	NN 
card 	NN 
career 	NN 
careful 	JJ 
carefully 	RB 
careless 	JJ 
carelessly 	RB 
care 	NN 
care 	VB 
car 	NN 
carpet 	NN 
carrot 	NN 
carry 	VBP 
case 	NN 
cash 	NN 
castle 	NN 
cast 	VBD 
cast 	VBN 
catch 	NN 
category 	NN 
cat 	NN 
cause 	VB 
CD 	NNP 
cease 	VB 
ceiling 	NN 
celebrate 	VB 
celebration 	NN 
cell 	NN 
cellphone 	NN 
cellular 	JJ 
center 	NN 
centimeter 	NN 
cent 	NN 
central 	JJ 
century 	NN 
ceremony 	NN 
certain 	JJ 
certainly 	RB 
certificate 	NN 
chain 	NN 
chairman 	NN 
chair 	NN 
chairwoman 	NN 
challenge 	NN 
chamber 	NN 
chance 	NN 
change 	NN 
channel 	NN 
chapter 	NN 
characteristic 	JJ 
character 	NN 
charge 	NN 
charity 	NN 
chart 	NN 
chase 	NN 
chat 	NN 
cheap 	JJ 
cheaply 	RB 
cheat 	VB 
check 	NN 
cheek 	NN 
cheerful 	JJ 
cheerfully 	RB 
cheese 	NN 
chemical 	NN 
chemist 	NN 
chemistry 	NN 
chest 	NN 
chew 	VB 
chicken 	NN 
chief 	NN 
childhood 	NN 
child 	NN 
chin 	NN 
chip 	NN 
chocolate 	NN 
choice 	NN 
choose 	VB 
chop 	VB 
church 	NN 
cigarette 	NN 
circle 	NN 
circumstance 	NN 
citizen 	NN 
city 	NN 
civil 	JJ 
claim 	NN 
classic 	JJ 
class 	NN 
classroom 	NN 
clean 	JJ 
clear 	JJ 
clearly 	RB 
clerk 	NN 
click 	VBP 
client 	NN 
climate 	NN 
climb 	NN 
clock 	NN 
closed 	VBD 
close 	JJ 
closely 	RB 
close 	NN 
closet 	NN 
clothes 	NNS 
clothing 	NN 
cloth 	NN 
cloud 	NN 
club 	NN 
cm 	NN 
c 	NN 
coach 	NN 
coal 	NN 
coast 	NN 
coat 	NN 
code 	NN 
coffee 	NN 
coin 	NN 
cold 	JJ 
coldly 	RB 
collapse 	NN 
colleague 	NN 
collection 	NN 
collect 	VB 
college 	NN 
colored 	VBN 
color 	NN 
column 	NN 
combination 	NN 
combine 	VBP 
comedy 	NN 
come 	VB 
comfortable 	JJ 
comfortably 	RB 
comfort 	NN 
command 	NN 
comment 	NN 
commercial 	JJ 
commission 	NN 
commitment 	NN 
committee 	NN 
commit 	VB 
common 	JJ 
commonly 	RB 
communicate 	VBP 
communication 	NN 
community 	NN 
company 	NN 
compare 	VBP 
comparison 	NN 
compete 	VB 
competition 	NN 
competitive 	JJ 
complaint 	NN 
complain 	VBP 
complete 	JJ 
completely 	RB 
complex 	NN 
complicated 	VBN 
complicate 	VBP 
component 	NN 
computer 	NN 
concentrate 	NN 
concentration 	NN 
concept 	NN 
concerned 	JJ 
concerning 	VBG 
concern 	NN 
concert 	NN 
conclude 	VBP 
conclusion 	NN 
concrete 	JJ 
condition 	NN 
conduct 	NN 
conference 	NN 
confidence 	NN 
confident 	JJ 
confidently 	RB 
confirm 	VBP 
conflict 	NN 
confront 	VBP 
confused 	JJ 
confuse 	VB 
confusing 	JJ 
confusion 	NN 
congratulations 	NNS 
congress 	NN 
connection 	NN 
connect 	VB 
conscious 	JJ 
consequence 	NN 
conservative 	JJ 
considerable 	JJ 
considerably 	RB 
consideration 	NN 
consider 	VBP 
consistent 	JJ 
consist 	VBP 
constant 	JJ 
constantly 	RB 
construction 	NN 
construct 	NN 
consult 	VB 
consumer 	NN 
contact 	NN 
container 	NN 
contain 	VBP 
contemporary 	JJ 
content 	NN 
contest 	NN 
context 	NN 
continent 	NN 
continue 	VBP 
continuous 	JJ 
continuously 	RB 
contract 	NN 
contrasting 	VBG 
contrast 	NN 
contribute 	VBP 
contribution 	NN 
controlled 	JJ 
control 	NN 
convenient 	JJ 
conventional 	JJ 
convention 	NN 
conversation 	NN 
convert 	VBP 
convince 	VB 
cookie 	NN 
cooking 	NN 
cook 	NN 
cook 	VBP 
cool 	JJ 
cooperation 	NN 
copy 	NN 
core 	NN 
corner 	NN 
correct 	JJ 
correctly 	RB 
cost 	NN 
cottage 	NN 
cotton 	NN 
cough 	NN 
could 	MD 
council 	NN 
counter 	NN 
count 	NN 
country 	NN 
countryside 	NN 
county 	NN 
couple 	NN 
courage 	NN 
course 	NN 
court 	NN 
cousin 	NN 
covered 	VBD 
covering 	VBG 
cover 	NN 
cow 	NN 
cracked 	VBD 
crack 	NN 
craft 	NN 
crash 	NN 
crazy 	JJ 
cream 	NN 
create 	VB 
creation 	NN 
creative 	JJ 
creature 	NN 
creditcard 	NN 
credit 	NN 
crime 	NN 
criminal 	JJ 
crisis 	NN 
crisp 	JJ 
criterion 	NN 
critical 	JJ 
criticism 	NN 
criticize 	VBP 
critic 	NN 
crop 	NN 
cross 	NN 
crowded 	VBD 
crowd 	NN 
crown 	NN 
crucial 	JJ 
cruel 	JJ 
crush 	NN 
cry 	NN 
cultural 	JJ 
culture 	NN 
cupboard 	NN 
cup 	NN 
cure 	NN 
curious 	JJ 
curiously 	RB 
curl 	VB 
curly 	JJ 
current 	JJ 
currently 	RB 
curtain 	NN 
curved 	VBD 
curve 	NN 
customer 	NN 
custom 	NN 
customs 	NNS 
cute 	JJ 
cut 	NN 
cycle 	NN 
cycling 	NN 
dad 	NN 
daily 	JJ 
damage 	NN 
damp 	JJ 
dance 	NN 
dancer 	NN 
dancing 	NN 
danger 	NN 
dangerous 	JJ 
dare 	VBP 
dark 	JJ 
data 	NNS 
date 	NN 
daughter 	NN 
day 	NN 
dead 	JJ 
deaf 	JJ 
deal 	NN 
dear 	RB 
death 	NN 
debate 	NN 
debt 	NN 
decade 	NN 
decay 	NN 
December 	NNP 
decent 	JJ 
decide 	VBP 
decision 	NN 
declare 	VB 
decline 	NN 
decorate 	VB 
decoration 	NN 
decorative 	JJ 
decrease 	NN 
decrease 	VBP 
deep 	JJ 
deeply 	RB 
defeat 	NN 
defeat 	VB 
defend 	VB 
defense 	NN 
define 	VB 
definite 	JJ 
definitely 	RB 
definition 	NN 
degree 	NN 
delay 	NN 
deliberate 	JJ 
deliberately 	RB 
delicate 	JJ 
delight 	NN 
deliver 	VBP 
delivery 	NN 
demand 	NN 
democracy 	NN 
democratic 	JJ 
demonstrate 	VBP 
demonstration 	NN 
dentist 	NN 
deny 	VBP 
department 	NN 
departure 	NN 
depend 	VBP 
deposit 	NN 
depressed 	VBD 
depressing 	JJ 
depress 	VBP 
depth 	NN 
derive 	VBP 
describe 	VBP 
description 	NN 
desert 	NN 
deserve 	VBP 
designer 	NN 
design 	NN 
desire 	NN 
desk 	NN 
desperate 	JJ 
desperately 	RB 
despite 	IN 
destroy 	VB 
destruction 	NN 
detailed 	JJ 
detail 	NN 
determination 	NN 
determined 	VBD 
determine 	VB 
development 	NN 
develop 	VB 
device 	NN 
devoted 	JJ 
devote 	VBP 
diagram 	NN 
dialog 	NN 
dialogue 	NN 
diamond 	NN 
diary 	NN 
dictionary 	NN 
diet 	NN 
die 	VB 
difference 	NN 
different 	JJ 
differently 	RB 
difficult 	JJ 
difficulty 	NN 
digital 	JJ 
dig 	NN 
dinner 	NN 
direction 	NN 
direct 	JJ 
directly 	RB 
director 	NN 
dirt 	NN 
dirty 	JJ 
disability 	NN 
disadvantage 	NN 
disagreement 	NN 
disagree 	VBP 
disappear 	VBP 
disappointed 	JJ 
disappointing 	JJ 
disappointment 	NN 
disappoint 	VBP 
disapproval 	NN 
disapprove 	VBP 
disapproving 	VBG 
disaster 	NN 
discipline 	NN 
disc 	NN 
discount 	NN 
discover 	VBP 
discovery 	NN 
discussion 	NN 
discuss 	VBP 
disease 	NN 
disgusted 	JJ 
disgusting 	JJ 
disgust 	NN 
dish 	NN 
dishonest 	JJ 
dishonestly 	RB 
disk 	NN 
dislike 	NN 
dismiss 	VB 
display 	NN 
dissolve 	VBP 
distance 	NN 
distant 	JJ 
distinguish 	VBP 
distribute 	VB 
distribution 	NN 
district 	NN 
disturbing 	JJ 
disturb 	VBP 
divide 	NN 
division 	NN 
divorced 	VBN 
divorce 	NN 
doctor 	NN 
document 	NN 
dog 	NN 
dollar 	NN 
domestic 	JJ 
dominate 	VB 
door 	NN 
dot 	NN 
double 	JJ 
double 	RB 
doubt 	NN 
do 	VBP 
down 	RB 
downstairs 	NNS 
downstairs 	RB 
downstairs 	VBZ 
downtown 	NN 
downward 	JJ 
downwards 	NNS 
dozen 	NN 
draft 	NN 
drag 	NN 
drama 	NN 
dramatically 	RB 
dramatic 	JJ 
drawer 	NN 
drawing 	VBG 
draw 	NN 
dream 	NN 
dressed 	VBN 
dress 	NN 
drink 	NN 
drive 	NN 
driver 	NN 
driving 	VBG 
drop 	NN 
drug 	NN 
drugstore 	NN 
drum 	VBP 
drunk 	JJ 
dry 	JJ 
due 	JJ 
dull 	JJ 
dump 	NN 
during 	IN 
dust 	NN 
duty 	NN 
DVD 	NN 
dying 	VBG 
each 	DT 
eager 	JJ 
early 	JJ 
ear 	NN 
earn 	VBP 
earth 	NN 
ease 	NN 
easily 	RB 
eastern 	JJ 
east 	JJ 
easy 	JJ 
eat 	VBP 
economic 	JJ 
economics 	NNS 
economy 	NN 
edge 	NN 
edition 	NN 
editor 	NN 
educated 	VBN 
educate 	VBP 
educational 	JJ 
education 	NN 
effective 	JJ 
effectively 	RB 
effect 	NN 
efficient 	JJ 
efficiently 	RB 
effort 	NN 
e.g. 	FW 
egg 	NN 
either 	CC 
elbow 	NN 
elderly 	JJ 
election 	NN 
electrical 	JJ 
electricity 	NN 
electric 	JJ 
electronic 	JJ 
elect 	VB 
elegant 	JJ 
element 	NN 
elevator 	NN 
eliminate 	VB 
else 	RB 
elsewhere 	RB 
e-mail 	JJ 
e-mail 	NN 
email 	NN 
embarrassed 	JJ 
embarrassing 	JJ 
embarrassment 	NN 
embarrass 	VBP 
emergency 	NN 
emerge 	VBP 
emotional 	JJ 
emotionally 	RB 
emotion 	NN 
emphasis 	NN 
emphasize 	VBP 
empire 	NN 
employee 	NN 
employer 	NN 
employment 	NN 
employ 	VBP 
empty 	JJ 
enable 	VBP 
encounter 	NN 
encouragement 	NN 
encourage 	VBP 
ending 	VBG 
end 	NN 
enemy 	NN 
energy 	NN 
engaged 	VBD 
engage 	VB 
engineering 	NN 
engineer 	NN 
engine 	NN 
enjoyable 	JJ 
enjoyment 	NN 
enjoy 	VB 
enormous 	JJ 
enough 	JJ 
enough 	RB 
ensure 	VB 
entertainer 	NN 
entertaining 	JJ 
entertainment 	NN 
entertain 	VB 
enter 	VB 
enthusiasm 	NN 
enthusiastic 	JJ 
entire 	JJ 
entirely 	RB 
entitle 	VB 
entrance 	NN 
entry 	NN 
envelope 	NN 
environmental 	JJ 
environment 	NN 
equal 	JJ 
equally 	RB 
equipment 	NN 
equivalent 	JJ 
era 	NN 
error 	NN 
escape 	NN 
especially 	RB 
essay 	NN 
essential 	JJ 
essentially 	RB 
establish 	VB 
estate 	NN 
estimate 	NN 
etc. 	FW 
ethnic 	JJ 
evening 	NN 
even 	RB 
event 	NN 
eventually 	RB 
ever 	RB 
everybody 	NN 
every 	DT 
everyone 	NN 
everything 	NN 
everywhere 	RB 
evidence 	NN 
evil 	JJ 
exact 	JJ 
exactly 	RB 
exaggerated 	JJ 
exaggerate 	VB 
examination 	NN 
examine 	VB 
exam 	NN 
example 	NN 
excellent 	JJ 
except 	IN 
exception 	NN 
exchange 	NN 
excited 	VBN 
excitement 	NN 
excite 	NN 
exciting 	JJ 
exclude 	VBP 
excluding 	VBG 
excuse 	NN 
executive 	NN 
exercise 	NN 
exhibition 	NN 
exhibit 	NN 
exhibit 	VBP 
existence 	NN 
exist 	VBP 
exit 	NN 
expand 	VB 
expectation 	NN 
expected 	VBN 
expect 	VBP 
expense 	NN 
expensive 	JJ 
experienced 	JJ 
experience 	NN 
experiment 	NN 
expert 	NN 
explain 	VBP 
explanation 	NN 
explode 	VB 
explore 	VB 
explosion 	NN 
export 	NN 
expose 	VB 
expression 	NN 
express 	VB 
express 	VBP 
extend 	VB 
extension 	NN 
extensive 	JJ 
extent 	NN 
extra 	JJ 
extraordinary 	JJ 
extreme 	JJ 
extremely 	RB 
eye 	NN 
face 	NN 
facility 	NN 
fact 	NN 
factor 	NN 
factory 	NN 
failure 	NN 
fail 	VBP 
faint 	JJ 
faintly 	RB 
fair 	JJ 
fairly 	RB 
faithful 	JJ 
faithfully 	RB 
faith 	NN 
fall 	NN 
false 	JJ 
fame 	NN 
familiar 	JJ 
family 	NN 
famous 	JJ 
fancy 	JJ 
fan 	NN 
farmer 	NN 
farming 	VBG 
farm 	NN 
far 	RB 
farther 	RBR 
farthest 	JJS 
fashionable 	JJ 
fashion 	NN 
fasten 	VB 
fast 	RB 
father 	NN 
fat 	JJ 
fault 	NN 
favorite 	JJ 
favor 	NN 
fear 	NN 
fear 	VBP 
feather 	NN 
feature 	NN 
February 	NNP 
federal 	JJ 
feed 	NN 
feeling 	NN 
feel 	VBP 
fee 	NN 
fellow 	JJ 
female 	JJ 
fence 	NN 
festival 	NN 
fever 	NN 
few 	JJ 
field 	NN 
fighting 	VBG 
fight 	NN 
figure 	NN 
file 	NN 
fill 	NN 
film 	NN 
final 	JJ 
finally 	RB 
finance 	NN 
financial 	JJ 
find 	VB 
fine 	JJ 
finely 	RB 
finger 	NN 
finished 	VBD 
finish 	NN 
fire 	NN 
firm 	JJ 
firmly 	RB 
firm 	NN 
first 	JJ 
fishing 	NN 
fish 	NN 
fit 	NN 
fixed 	VBN 
fix 	NN 
flag 	NN 
flame 	NN 
flash 	NN 
flat 	JJ 
flavor 	NN 
flesh 	NN 
flight 	NN 
float 	NN 
flood 	NN 
floor 	NN 
flour 	NN 
flower 	NN 
flow 	NN 
flu 	NN 
flying 	VBG 
fly 	NN 
focus 	NN 
folding 	JJ 
fold 	NN 
folk 	NN 
following 	VBG 
follow 	VB 
food 	NN 
football 	NN 
foot 	NN 
force 	NN 
forecast 	NN 
foreign 	JJ 
forest 	NN 
forever 	RB 
forget 	VB 
forgive 	VBP 
for 	IN 
fork 	NN 
formal 	JJ 
formally 	RB 
former 	JJ 
formerly 	RB 
form 	NN 
formula 	NN 
fortune 	NN 
forward 	RB 
forwards 	RB 
foundation 	NN 
found 	VBD 
frame 	NN 
freedom 	NN 
free 	JJ 
freely 	RB 
freeze 	NN 
frequent 	JJ 
frequently 	RB 
fresh 	JJ 
freshly 	RB 
Friday 	NNP 
friendly 	JJ 
friend 	NN 
friendship 	NN 
frightened 	VBD 
frightening 	JJ 
frighten 	NN 
from 	IN 
front 	JJ 
frozen 	JJ 
fruit 	NN 
fry 	NN 
fuel 	NN 
full 	JJ 
fully 	RB 
function 	NN 
fundamental 	JJ 
fund 	NN 
funeral 	NN 
fun 	NN 
funny 	JJ 
furniture 	NN 
fur 	NN 
further 	JJ 
furthest 	JJS 
future 	JJ 
gain 	NN 
gallon 	NN 
gamble 	NN 
gambling 	NN 
game 	NN 
gap 	NN 
garage 	NN 
garbage 	NN 
garden 	NN 
gas 	NN 
gasoline 	NN 
gate 	NN 
gather 	VBP 
gay 	JJ 
gear 	NN 
gene 	NN 
general 	JJ 
generally 	RB 
generate 	VBP 
generation 	NN 
generous 	JJ 
generously 	RB 
gentle 	JJ 
gentleman 	NN 
gently 	RB 
genuine 	JJ 
genuinely 	RB 
geography 	NN 
get 	VB 
giant 	JJ 
gift 	NN 
girlfriend 	NN 
girl 	NN 
give 	VBP 
glad 	JJ 
glasses 	NNS 
glass 	NN 
global 	JJ 
glove 	NN 
glue 	NN 
goal 	NN 
god 	NN 
gold 	NN 
goodbye 	NN 
good 	JJ 
goods 	NNS 
go 	VB 
government 	NN 
governor 	NN 
govern 	VBP 
grab 	NN 
grade 	NN 
gradual 	JJ 
gradually 	RB 
graduate 	JJ 
graduate 	NN 
grain 	NN 
grammar 	NN 
grandchild 	NN 
granddaughter 	NN 
grandfather 	NN 
grand 	JJ 
grandmother 	NN 
grandparent 	NN 
grandson 	NN 
grant 	NN 
grass 	NN 
grateful 	JJ 
grave 	JJ 
grave 	NN 
gray 	JJ 
great 	JJ 
greatly 	RB 
green 	JJ 
groceries 	NNS 
grocery 	NN 
ground 	NN 
group 	NN 
growth 	NN 
grow 	VB 
guarantee 	NN 
guard 	NN 
guess 	NN 
guest 	NN 
guide 	NN 
guilty 	JJ 
guitar 	NN 
gun 	NN 
guy 	NN 
habit 	NN 
hairdresser 	NN 
hair 	NN 
half 	NN 
hall 	NN 
hammer 	NN 
handle 	VB 
hand 	NN 
hang 	VBP 
happen 	VB 
happily 	RB 
happiness 	NN 
happy 	JJ 
hard 	JJ 
hardly 	RB 
harmful 	JJ 
harmless 	JJ 
harm 	NN 
hate 	NN 
hat 	NN 
hatred 	NN 
have 	VBP 
headache 	NN 
head 	NN 
health 	NN 
healthy 	JJ 
heal 	VBP 
hearing 	NN 
heart 	NN 
hear 	VBP 
heating 	NN 
heat 	NN 
heaven 	NN 
heavily 	RB 
heavy 	JJ 
heel 	NN 
height 	NN 
hell 	NN 
hello 	UH 
helpful 	JJ 
help 	NN 
help 	VB 
he 	PRP 
here 	RB 
hero 	NN 
her 	PRP$ 
herself 	PRP 
hers 	NNS 
hesitate 	VB 
hide 	VB 
high 	JJ 
highlight 	NN 
highly 	RB 
high 	RB 
highschool 	JJ 
highway 	NN 
hill 	NN 
him 	PRP 
himself 	PRP 
hip 	NN 
hire 	VB 
his 	PRP$ 
historical 	JJ 
history 	NN 
hit 	NN 
hit 	VBD 
hi 	UH 
hobby 	NN 
hold 	NN 
hold 	VBP 
hole 	NN 
holiday 	NN 
hollow 	JJ 
holy 	JJ 
home 	NN 
homework 	NN 
honest 	JJ 
honestly 	RB 
honor 	NN 
hook 	NN 
hopefully 	RB 
hope 	NN 
hope 	VBP 
horizontal 	JJ 
horn 	NN 
horror 	NN 
horse 	NN 
hospital 	NN 
host 	NN 
hotel 	NN 
hot 	JJ 
hour 	NN 
household 	NN 
house 	NN 
housing 	NN 
however 	RB 
how 	WRB 
huge 	JJ 
human 	JJ 
humor 	NN 
humorous 	JJ 
hungry 	JJ 
hunting 	NN 
hunt 	NN 
hurry 	NN 
hurt 	VBD 
husband 	NN 
ice-cream 	JJ 
ice 	NN 
ideal 	JJ 
ideally 	RB 
idea 	NN 
identify 	VBP 
identity 	NN 
i.e. 	FW 
if 	IN 
ignore 	VB 
illegal 	JJ 
illegally 	RB 
ill 	JJ 
illness 	NN 
illustrate 	VBP 
image 	NN 
imaginary 	JJ 
imagination 	NN 
imagine 	VBP 
immediate 	JJ 
immediately 	RB 
immoral 	JJ 
impact 	NN 
impatiently 	RB 
impatient 	NN 
implication 	NN 
imply 	VBP 
importance 	NN 
important 	JJ 
importantly 	RB 
import 	NN 
impose 	VB 
impossible 	JJ 
impressed 	JJ 
impression 	NN 
impressive 	JJ 
impress 	VB 
improvement 	NN 
improve 	VB 
inability 	NN 
inch 	NN 
incident 	NN 
include 	VBP 
including 	VBG 
income 	NN 
increase 	NN 
increasingly 	RB 
indeed 	RB 
independence 	NN 
independent 	JJ 
independently 	RB 
index 	NN 
indicate 	VBP 
indication 	NN 
indirect 	JJ 
indirectly 	RB 
individual 	JJ 
indoor 	JJ 
indoors 	RB 
industrial 	JJ 
industry 	NN 
inevitable 	JJ 
inevitably 	RB 
infected 	JJ 
infection 	NN 
infectious 	JJ 
infect 	VB 
influence 	NN 
informal 	JJ 
information 	NN 
inform 	VBP 
ingredient 	NN 
in 	IN 
initial 	JJ 
initially 	RB 
initiative 	NN 
injured 	VBN 
injure 	NN 
injury 	NN 
ink 	NN 
inner 	JJ 
innocent 	JJ 
inquiry 	NN 
insect 	JJ 
insert 	NN 
inside 	IN 
inside 	JJ 
insist 	VBP 
install 	VB 
instance 	NN 
instead 	RB 
institute 	NN 
institution 	NN 
instruction 	NN 
instrument 	NN 
insulting 	JJ 
insult 	NN 
insurance 	NN 
intellectual 	JJ 
intelligence 	NN 
intelligent 	JJ 
intended 	JJ 
intend 	VBP 
intense 	JJ 
intention 	NN 
interested 	JJ 
interesting 	JJ 
interest 	NN 
interior 	JJ 
internal 	JJ 
international 	JJ 
Internet 	NN 
interpretation 	NN 
interpret 	VB 
interruption 	NN 
interrupt 	JJ 
interval 	NN 
interview 	NN 
into 	IN 
introduce 	VB 
introduction 	NN 
invention 	NN 
invent 	VB 
investigate 	VB 
investigation 	NN 
investment 	NN 
invest 	VBP 
invitation 	NN 
invite 	VB 
involvement 	NN 
involve 	VBP 
I 	PRP 
iron 	NN 
iron 	VB 
irritated 	JJ 
irritate 	JJ 
irritating 	JJ 
island 	NN 
issue 	NN 
item 	NN 
it 	PRP 
itself 	PRP 
its 	PRP$ 
jacket 	NN 
jail 	NN 
January 	NNP 
jealous 	JJ 
jeans 	NNS 
jelly 	RB 
jewelry 	NN 
job 	NN 
joint 	JJ 
jointly 	RB 
join 	VB 
joke 	NN 
journalist 	NN 
journey 	NN 
joy 	NN 
judgement 	NN 
judge 	NN 
judgment 	NN 
juice 	NN 
July 	NNP 
jump 	NN 
June 	NNP 
junior 	NN 
jury 	NN 
justice 	NN 
justified 	JJ 
justify 	VB 
just 	RB 
keen 	JJ 
keep 	VB 
keyboard 	NN 
key 	JJ 
kick 	NN 
kid 	NN 
killing 	VBG 
kill 	NN 
kilogram 	NN 
kilo 	NN 
kindly 	RB 
kindness 	NN 
kind 	NN 
king 	NN 
kiss 	NN 
kitchen 	NN 
knee 	NN 
knife 	NN 
knock 	VB 
knot 	NN 
knowledge 	NN 
know 	VBP 
label 	NN 
lab 	NN 
laboratory 	NN 
labor 	NN 
lacking 	VBG 
lack 	NN 
lady 	NN 
lake 	NN 
lamp 	NN 
land 	NN 
landscape 	NN 
lane 	NN 
language 	NN 
large 	JJ 
largely 	RB 
last 	JJ 
late 	JJ 
lately 	RB 
later 	RB 
latest 	JJS 
latter 	JJ 
laugh 	NN 
launch 	NN 
laundry 	NN 
law 	NN 
lawyer 	NN 
layer 	NN 
lay 	VBD 
lazy 	JJ 
leader 	NN 
leading 	VBG 
lead 	NN 
leaf 	NN 
league 	NN 
lean 	JJ 
learn 	VBP 
least 	JJS 
leather 	NN 
leave 	NN 
lecture 	NN 
left 	JJ 
left 	VBD 
legal 	JJ 
legally 	RB 
leg 	NN 
lemon 	JJ 
lend 	VBP 
length 	NN 
less 	JJR 
lesson 	NN 
less 	RBR 
letter 	NN 
let 	VB 
level 	NN 
liberal 	JJ 
library 	NN 
license 	NN 
lid 	NN 
lie 	NN 
lie 	VBP 
life 	NN 
lift 	NN 
light 	JJ 
lightly 	RB 
light 	NN 
like 	IN 
likely 	JJ 
limited 	JJ 
limit 	NN 
line 	NN 
link 	NN 
lip 	NN 
liquid 	NN 
listen 	VBP 
list 	NN 
literature 	NN 
liter 	NN 
little 	JJ 
little 	RB 
live 	JJ 
lively 	JJ 
living 	NN 
load 	NN 
loan 	NN 
local 	JJ 
locally 	RB 
locate 	VB 
location 	NN 
lock 	NN 
logical 	JJ 
logic 	NN 
lonely 	JJ 
long 	RB 
look 	NN 
look 	VB 
loose 	JJ 
loosely 	RB 
lord 	NN 
lose 	VBP 
loss 	NN 
lost 	VBD 
lot 	NN 
loud 	JJ 
loudly 	RB 
love 	NN 
lover 	NN 
love 	VBP 
lower 	JJR 
low 	JJ 
loyal 	JJ 
luck 	NN 
lucky 	JJ 
lump 	NN 
lunch 	NN 
lung 	NN 
machine 	NN 
machinery 	NN 
mad 	JJ 
magazine 	NN 
magic 	JJ 
mail 	NN 
main 	JJ 
mainly 	RB 
maintain 	VBP 
majority 	NN 
major 	JJ 
make-up 	NN 
make 	VB 
make 	VBP 
male 	JJ 
mall 	NN 
management 	NN 
manager 	NN 
manage 	VBP 
manner 	NN 
man 	NN 
manufacture 	NN 
manufacturer 	NN 
manufacturing 	VBG 
many 	JJ 
map 	NN 
march 	NN 
March 	NNP 
march 	VB 
marker 	NN 
marketing 	NN 
market 	NN 
mark 	NN 
marriage 	NN 
married 	VBN 
marry 	VB 
massive 	JJ 
mass 	NN 
master 	NN 
matching 	VBG 
match 	NN 
mate 	NN 
material 	NN 
mathematics 	NNS 
math 	NN 
matter 	NN 
maximum 	NN 
maybe 	RB 
may 	MD 
May 	NNP 
mayor 	NN 
meal 	NN 
meaning 	NN 
mean 	JJ 
means 	VBZ 
meanwhile 	RB 
measurement 	NN 
measure 	NN 
meat 	NN 
media 	NNS 
medicine 	NN 
medium 	NN 
meeting 	NN 
meet 	VBP 
melt 	VB 
member 	NN 
membership 	NN 
memory 	NN 
mental 	JJ 
mentally 	RB 
mention 	VB 
menu 	NN 
me 	PRP 
mere 	JJ 
merely 	RB 
message 	NN 
mess 	NN 
messy 	JJ 
metal 	NN 
meter 	NN 
method 	NN 
middle 	JJ 
midnight 	NN 
might 	MD 
mild 	JJ 
mile 	NN 
military 	JJ 
milk 	NN 
milligram 	NN 
millimeter 	NN 
mind 	NN 
mine 	NN 
mineral 	NN 
minimum 	JJ 
minimum 	NN 
minister 	NN 
ministry 	NN 
minority 	NN 
minor 	JJ 
minute 	NN 
mirror 	NN 
missing 	VBG 
Miss 	NNP 
miss 	VBP 
mistaken 	JJ 
mistake 	NN 
mixed 	JJ 
mix 	NN 
mixture 	NN 
mobile 	JJ 
model 	NN 
modern 	JJ 
moment 	NN 
mom 	NN 
Monday 	NNP 
money 	NN 
monitor 	NN 
month 	NN 
mood 	NN 
moon 	NN 
moral 	JJ 
morally 	RB 
moreover 	RB 
more 	RBR 
morning 	NN 
mostly 	RB 
most 	RBS 
mother 	NN 
motion 	NN 
motorcycle 	NN 
motor 	NN 
mountain 	NN 
mount 	VB 
mouse 	NN 
mouth 	NN 
movement 	NN 
move 	NN 
movie 	NN 
moving 	VBG 
Mr. 	NNP 
Mrs. 	NNP 
Ms. 	NNP 
much 	JJ 
much 	RB 
mud 	NN 
multiply 	VB 
murder 	NN 
muscle 	NN 
museum 	NN 
musical 	JJ 
musician 	NN 
music 	NN 
must 	MD 
my 	PRP$ 
myself 	PRP 
mysterious 	JJ 
mystery 	NN 
nail 	NN 
naked 	JJ 
name 	NN 
narrow 	JJ 
national 	JJ 
nation 	NN 
native 	JJ 
natural 	JJ 
naturally 	RB 
nature 	NN 
navy 	NN 
nearby 	JJ 
near 	IN 
nearly 	RB 
neat 	JJ 
neatly 	RB 
necessarily 	RB 
necessary 	JJ 
neck 	NN 
needle 	NN 
need 	MD 
need 	VB 
need 	VBP 
negative 	JJ 
neighborhood 	NN 
neighbor 	NN 
neither 	CC 
nephew 	NN 
nerve 	NN 
nervous 	JJ 
nervously 	RB 
nest 	NN 
net 	JJ 
network 	NN 
never 	RB 
nevertheless 	RB 
new 	JJ 
newly 	RB 
news 	NN 
newspaper 	NN 
next 	IN 
next 	JJ 
nice 	JJ 
nicely 	RB 
niece 	JJ 
night 	NN 
nobody 	NN 
nod 	NN 
no 	DT 
noise 	NN 
noisily 	RB 
noisy 	JJ 
none 	NN 
nonsense 	NN 
noone 	NN 
nor 	CC 
normal 	JJ 
normally 	RB 
northern 	JJ 
north 	NN 
nose 	NN 
note 	NN 
note 	VB 
nothing 	NN 
noticeable 	JJ 
notice 	NN 
notion 	NN 
not 	RB 
novel 	JJ 
November 	NNP 
nowhere 	RB 
now 	RB 
nuclear 	JJ 
number 	NN 
numerous 	JJ 
nurse 	NN 
nut 	NN 
obey 	VB 
objective 	JJ 
object 	NN 
observation 	NN 
observe 	VBP 
obtain 	VB 
obvious 	JJ 
obviously 	RB 
occasionally 	RB 
occasion 	NN 
occupied 	JJ 
occupy 	VBP 
occur 	VBP 
ocean 	NN 
o'clock 	RB 
October 	NNP 
odd 	JJ 
oddly 	RB 
offend 	VB 
offense 	NN 
offensive 	JJ 
offer 	NN 
office 	NN 
officer 	NN 
official 	JJ 
officially 	RB 
official 	NN 
off 	IN 
of 	IN 
often 	RB 
oh 	UH 
oil 	NN 
okay 	JJ 
OK 	JJ 
old-fashioned 	JJ 
old 	JJ 
once 	RB 
one 	CD 
on 	IN 
onion 	NN 
online 	NN 
only 	RB 
onto 	IN 
opening 	NN 
open 	JJ 
openly 	RB 
operate 	VBP 
operation 	NN 
opinion 	NN 
opponent 	NN 
opportunity 	NN 
oppose 	VBP 
opposing 	VBG 
opposite 	JJ 
opposition 	NN 
option 	NN 
orange 	NN 
or 	CC 
order 	NN 
ordinary 	JJ 
organization 	NN 
organized 	VBN 
organize 	VBP 
organ 	NN 
original 	JJ 
originally 	RB 
origin 	NN 
other 	JJ 
otherwise 	RB 
ought 	MD 
ounce 	NN 
our 	PRP$ 
ourselves 	PRP 
ours 	PRP 
outdoor 	JJ 
outdoors 	NNS 
outer 	JJ 
out 	IN 
outline 	NN 
output 	NN 
out 	RP 
outside 	IN 
outside 	JJ 
outstanding 	JJ 
oven 	NN 
overall 	JJ 
overcome 	VBN 
over 	IN 
overseas 	JJ 
owe 	VBP 
owner 	NN 
own 	JJ 
pace 	NN 
package 	NN 
pack 	NN 
page 	NN 
painful 	JJ 
pain 	NN 
painter 	NN 
painting 	NN 
paint 	NN 
pair 	NN 
palace 	NN 
pale 	JJ 
panel 	NN 
pan 	NN 
pants 	NNS 
paper 	NN 
parallel 	JJ 
parent 	NN 
park 	NN 
parliament 	NN 
participate 	VBP 
particular 	JJ 
particularly 	RB 
partly 	RB 
partner 	NN 
partnership 	NN 
part 	NN 
party 	NN 
passage 	NN 
passenger 	NN 
passing 	VBG 
passion 	NN 
pass 	NN 
passport 	NN 
past 	JJ 
path 	NN 
patience 	NN 
patient 	NN 
pattern 	NN 
pause 	NN 
payment 	NN 
pay 	NN 
peaceful 	JJ 
peace 	NN 
peak 	NN 
penalty 	NN 
pencil 	NN 
pen 	NN 
people 	NNS 
pepper 	NN 
percentage 	NN 
percent 	NN 
perfect 	JJ 
perfectly 	RB 
performance 	NN 
performer 	NN 
perform 	VB 
perhaps 	RB 
per 	IN 
period 	NN 
permanent 	JJ 
permanently 	RB 
permission 	NN 
permit 	NN 
personality 	NN 
personal 	JJ 
personally 	RB 
person 	NN 
perspective 	NN 
persuade 	VB 
pet 	JJ 
phase 	NN 
philosophy 	NN 
phone 	NN 
photocopy 	VB 
photographer 	NNP 
photograph 	NN 
photography 	NN 
photo 	NN 
phrase 	NN 
physical 	JJ 
physically 	RB 
physics 	NN 
piano 	NN 
pick 	NN 
picture 	NN 
piece 	NN 
pig 	NN 
pile 	NN 
pill 	NN 
pilot 	NN 
pink 	NN 
pin 	NN 
pint 	NN 
pipe 	NN 
pitch 	NN 
place 	NN 
plain 	RB 
plane 	NN 
planet 	NN 
planning 	NN 
plan 	NN 
plant 	NN 
plastic 	JJ 
plastic 	NN 
plate 	NN 
platform 	NN 
player 	NN 
play 	NN 
play 	VBP 
pleasant 	JJ 
pleasantly 	RB 
pleased 	JJ 
please 	VB 
pleasure 	NN 
plenty 	JJ 
plenty 	NN 
plot 	NN 
plug 	NN 
plus 	CC 
p.m. 	RB 
pocket 	NN 
poem 	NN 
poetry 	NN 
pointed 	VBD 
point 	NN 
poison 	NN 
poisonous 	JJ 
pole 	NN 
police 	NN 
policy 	NN 
polish 	NN 
polite 	JJ 
politely 	RB 
political 	JJ 
politically 	RB 
politician 	NN 
politics 	NNS 
pollution 	NN 
pool 	NN 
poor 	JJ 
pop 	NN 
popular 	JJ 
population 	NN 
port 	NN 
pose 	VB 
pose 	VBP 
position 	NN 
positive 	JJ 
possession 	NN 
possess 	VBP 
possibility 	NN 
possible 	JJ 
possibly 	RB 
post 	NN 
post-office 	JJ 
post 	VB 
potato 	NN 
potential 	JJ 
potentially 	RB 
pot 	NN 
pound 	NN 
pour 	VBP 
poverty 	NN 
powder 	NN 
powerful 	JJ 
power 	NN 
practical 	JJ 
practically 	RB 
practice 	NN 
praise 	NN 
prayer 	NN 
precise 	JJ 
precisely 	RB 
predict 	VBP 
preference 	NN 
prefer 	VBP 
pregnant 	JJ 
premises 	NNS 
preparation 	NN 
prepared 	JJ 
prepare 	VBP 
presence 	NN 
presentation 	NN 
present 	JJ 
preserve 	VB 
president 	NN 
press 	NN 
pressure 	NN 
presumably 	RB 
pretend 	JJ 
pretty 	RB 
prevent 	VB 
previous 	JJ 
previously 	RB 
price 	NN 
pride 	NN 
priest 	NN 
primarily 	RB 
primary 	JJ 
prime-minister 	NN 
prince 	NN 
princess 	NN 
principal 	NN 
principle 	NN 
printer 	NN 
print 	NN 
priority 	NN 
prior 	RB 
prisoner 	NN 
prison 	NN 
private 	JJ 
privately 	RB 
prize 	NN 
probably 	RB 
problem 	NN 
procedure 	NN 
proceed 	VB 
process 	NN 
producer 	NN 
produce 	VBP 
production 	NN 
product 	NN 
professional 	JJ 
profession 	NN 
professor 	NN 
profile 	NN 
profit 	NN 
program 	NN 
progress 	NN 
project 	NN 
promise 	NN 
promise 	VBP 
promote 	VB 
promotion 	NN 
prompt 	JJ 
promptly 	RB 
pronounce 	VBP 
pronunciation 	NN 
proof 	NN 
proper 	JJ 
property 	NN 
proportion 	NN 
proposal 	NN 
propose 	VBP 
prospect 	NN 
protection 	NN 
protect 	VBP 
protest 	NN 
proud 	JJ 
proudly 	RB 
prove 	VBP 
provided 	VBN 
provide 	VBP 
publication 	NN 
publicity 	NN 
public 	JJ 
publicly 	RB 
publishing 	NN 
publish 	VB 
pull 	VB 
punch 	NN 
punishment 	NN 
punish 	VBP 
purchase 	NN 
pure 	JJ 
purely 	RB 
purple 	JJ 
purpose 	NN 
pursue 	VB 
push 	NN 
put 	VBD 
qualification 	NN 
qualified 	VBD 
qualify 	VB 
quality 	NN 
quantity 	NN 
quarter 	NN 
queen 	NN 
question 	NN 
quick 	JJ 
quickly 	RB 
quiet 	JJ 
quietly 	RB 
quite 	RB 
quit 	VB 
quote 	NN 
race 	NN 
racing 	NN 
radio 	NN 
rail 	NN 
railroad 	NN 
rain 	NN 
raise 	NN 
range 	NN 
rank 	NN 
rapid 	JJ 
rapidly 	RB 
rare 	JJ 
rarely 	RB 
rate 	NN 
rather 	RB 
raw 	JJ 
reach 	NN 
reaction 	NN 
react 	VBP 
reader 	NN 
reading 	NN 
read 	VBP 
ready 	JJ 
realistic 	JJ 
reality 	NN 
realize 	VBP 
real 	JJ 
really 	RB 
rear 	JJ 
reasonable 	JJ 
reasonably 	RB 
reason 	NN 
recall 	NN 
receipt 	NN 
receive 	VBP 
recent 	JJ 
recently 	RB 
reception 	NN 
recognition 	NN 
recognize 	VBP 
recommendation 	NN 
recommend 	VB 
recording 	NN 
record 	NN 
recover 	VB 
recovery 	NN 
red 	JJ 
reduce 	VB 
reduction 	NN 
reference 	NN 
refer 	VBP 
reflect 	VBP 
reform 	NN 
refrigerator 	NN 
refusal 	NN 
refuse 	VBP 
regarding 	VBG 
regard 	NN 
regional 	JJ 
region 	NN 
register 	NN 
register 	VBP 
regret 	NN 
regular 	JJ 
regularly 	RB 
regulation 	NN 
reject 	VBP 
related 	JJ 
relate 	VBP 
relation 	NN 
relationship 	NN 
relative 	JJ 
relatively 	RB 
relaxed 	VBN 
relaxing 	NN 
relax 	VB 
release 	NN 
relevant 	JJ 
relief 	NN 
religion 	NN 
religious 	JJ 
rely 	VBP 
remaining 	VBG 
remains 	VBZ 
remain 	VBP 
remarkable 	JJ 
remarkably 	RB 
remark 	NN 
remember 	VBP 
remind 	JJ 
remote 	JJ 
removal 	NN 
remove 	VB 
rent 	NN 
repair 	NN 
repeatedly 	RB 
repeated 	VBN 
repeat 	NN 
replace 	VB 
reply 	NN 
reporter 	NN 
report 	NN 
representative 	JJ 
represent 	VBP 
reproduce 	VB 
reputation 	NN 
request 	NN 
requirement 	NN 
require 	VBP 
rescue 	NN 
research 	NN 
reservation 	NN 
reserve 	NN 
resident 	JJ 
resistance 	NN 
resist 	VBP 
resolve 	NN 
resort 	NN 
resource 	NN 
respect 	NN 
respond 	VBP 
response 	NN 
responsibility 	NN 
responsible 	JJ 
restaurant 	NN 
rest 	NN 
restore 	VB 
restricted 	JJ 
restriction 	NN 
restrict 	VB 
result 	NN 
result 	VBP 
retain 	VB 
retired 	JJ 
retirement 	NN 
retire 	VB 
return 	NN 
reveal 	VBP 
reverse 	JJ 
review 	NN 
revise 	VBP 
revision 	NN 
revolution 	NN 
reward 	NN 
rhythm 	NN 
rice 	NN 
rich 	JJ 
ride 	NN 
rider 	NN 
ridiculous 	JJ 
riding 	VBG 
rid 	JJ 
right 	JJ 
rightly 	RB 
right 	RB 
ring 	NN 
rise 	NN 
risk 	NN 
rival 	JJ 
river 	NN 
road 	NN 
rob 	NN 
rock 	NN 
role 	NN 
roll 	NN 
romantic 	JJ 
roof 	NN 
room 	NN 
root 	NN 
rope 	NN 
rose 	VBD 
rough 	JJ 
roughly 	RB 
round 	JJ 
round 	NN 
route 	NN 
routine 	JJ 
row 	NN 
royal 	NN 
rubber 	NN 
rub 	NN 
rude 	JJ 
rudely 	RB 
ruined 	VBN 
ruin 	VB 
ruin 	VBP 
rule 	NN 
ruler 	NN 
rumor 	NN 
runner 	NN 
running 	VBG 
run 	NN 
rural 	JJ 
rush 	NN 
sack 	NN 
sad 	JJ 
sadly 	RB 
sadness 	NN 
safe 	JJ 
safely 	RB 
safety 	NN 
sailing 	NN 
sail 	NN 
sailor 	NN 
sail 	VB 
salad 	NN 
salary 	NN 
sale 	NN 
salt 	NN 
salty 	JJ 
same 	JJ 
sample 	NN 
sand 	NN 
satisfaction 	NN 
satisfied 	JJ 
satisfying 	JJ 
satisfy 	VB 
Saturday 	NNP 
sauce 	NN 
save 	VB 
saving 	VBG 
say 	VBP 
scale 	NN 
scared 	JJ 
scare 	NN 
scary 	JJ 
scene 	NN 
schedule 	NN 
school 	NN 
science 	NN 
scientific 	JJ 
scientist 	NN 
scissors 	NNS 
score 	NN 
score 	VBP 
scratch 	NN 
scream 	VB 
screen 	NN 
screw 	NN 
screw 	VBP 
seal 	NN 
sea 	NN 
search 	NN 
season 	NN 
seat 	NN 
secondary 	JJ 
second 	JJ 
secretary 	NN 
secret 	JJ 
secretly 	RB 
secret 	NN 
section 	NN 
sector 	NN 
secure 	JJ 
security 	NN 
seed 	NN 
seek 	VBP 
seem 	VBP 
see 	VB 
selection 	NN 
select 	JJ 
self 	NN 
sell 	NN 
semester 	NN 
senate 	NN 
senator 	NN 
send 	VBP 
senior 	JJ 
sense 	NN 
sensible 	JJ 
sensitive 	JJ 
sentence 	NN 
separated 	JJ 
separate 	JJ 
separately 	RB 
separation 	NN 
September 	NNP 
series 	NN 
serious 	JJ 
seriously 	RB 
servant 	JJ 
serve 	VBP 
service 	NN 
session 	NN 
settle 	VB 
set 	VBD 
set 	VBN 
several 	JJ 
severe 	JJ 
severely 	RB 
sew 	VB 
sex 	NN 
sexual 	JJ 
sexually 	RB 
shade 	NN 
shadow 	NN 
shake 	NN 
shall 	MD 
shallow 	JJ 
shame 	NN 
shaped 	VBN 
shape 	NN 
share 	NN 
sharp 	JJ 
sharply 	RB 
shave 	VB 
sheep 	NN 
sheet 	NN 
shelf 	NN 
shell 	NN 
shelter 	NN 
she 	PRP 
shift 	NN 
shift 	VB 
shine 	VB 
shiny 	JJ 
ship 	NN 
shirt 	NN 
shocked 	VBD 
shocking 	JJ 
shock 	NN 
shoe 	NN 
shooting 	NN 
shoot 	NN 
shop 	NN 
shopping 	NN 
short 	JJ 
shortly 	RB 
shot 	VBN 
shoulder 	NN 
should 	MD 
shout 	NN 
shout 	VB 
shower 	NN 
show 	NN 
show 	VBP 
shut 	VBD 
shy 	JJ 
sick 	JJ 
side 	NN 
sideways 	RB 
sight 	NN 
signal 	NN 
signature 	NN 
significant 	JJ 
significantly 	RB 
sign 	NN 
sign 	VB 
silence 	NN 
silent 	JJ 
silk 	NN 
silly 	JJ 
silver 	NN 
similar 	JJ 
similarly 	RB 
simple 	JJ 
simply 	RB 
since 	IN 
sincere 	JJ 
sincerely 	RB 
singer 	NN 
singing 	NN 
single 	JJ 
sing 	VB 
sink 	NN 
sir 	NN 
sister 	NN 
site 	NN 
situation 	NN 
sit 	VBP 
size 	NN 
skilled 	JJ 
skillful 	JJ 
skillfully 	RB 
skill 	NN 
skin 	NN 
skirt 	NN 
sky 	NN 
sleep 	NN 
sleeve 	NN 
slice 	NN 
slide 	NN 
slight 	JJ 
slightly 	RB 
slip 	VBP 
slope 	NN 
slow 	JJ 
slowly 	RB 
small 	JJ 
smart 	JJ 
smash 	NN 
smash 	VBP 
smell 	NN 
smile 	NN 
smoke 	NN 
smoking 	NN 
smooth 	JJ 
smoothly 	RB 
snake 	NN 
snow 	NN 
soap 	NN 
social 	JJ 
socially 	RB 
society 	NN 
sock 	NN 
soft 	JJ 
softly 	RB 
software 	NN 
soil 	NN 
soldier 	NN 
solid 	JJ 
solution 	NN 
solve 	VB 
somebody 	NN 
some 	DT 
somehow 	RB 
someone 	NN 
something 	NN 
sometimes 	RB 
somewhat 	RB 
somewhere 	RB 
song 	NN 
son 	NN 
soon 	RB 
so 	RB 
sore 	JJ 
sorry 	JJ 
sort 	NN 
soul 	NN 
sound 	JJ 
sound 	NN 
soup 	NN 
source 	NN 
sour 	JJ 
southern 	JJ 
south 	JJ 
south 	RB 
space 	NN 
spare 	JJ 
speaker 	NN 
speak 	VBP 
specialist 	NN 
special 	JJ 
specially 	RB 
species 	NNS 
specifically 	RB 
specific 	JJ 
speech 	NN 
speed 	NN 
spelling 	NN 
spell 	NN 
spend 	VBP 
spice 	NN 
spicy 	JJ 
spider 	NN 
spill 	NN 
spin 	VB 
spirit 	NN 
spiritual 	JJ 
spite 	NN 
split 	NN 
spoil 	VBP 
spoken 	VBN 
spoon 	NN 
sport 	NN 
spot 	NN 
spray 	NN 
spread 	VBD 
spring 	NN 
square 	JJ 
squeeze 	NN 
stable 	JJ 
staff 	NN 
stage 	NN 
stair 	NN 
stamp 	NN 
standard 	JJ 
stand 	NN 
stand 	VB 
stare 	VB 
star 	NN 
start 	NN 
statement 	NN 
state 	NN 
station 	NN 
statue 	NN 
status 	NN 
stay 	VB 
steadily 	RB 
steady 	JJ 
steal 	VBP 
steam 	NN 
steel 	NN 
steep 	JJ 
steeply 	RB 
steer 	VB 
step 	NN 
stick 	NN 
sticky 	JJ 
stiff 	NN 
still 	RB 
sting 	NN 
sting 	VBG 
stir 	VB 
stock 	NN 
stomach 	NN 
stone 	NN 
stop 	VB 
store 	NN 
storm 	NN 
story 	NN 
stove 	NN 
straight 	JJ 
strain 	NN 
strange 	JJ 
strangely 	RB 
stranger 	NN 
strategy 	NN 
stream 	NN 
street 	NN 
strength 	NN 
stressed 	VBD 
stress 	NN 
stretch 	NN 
strict 	JJ 
strictly 	RB 
strike 	NN 
strike 	VB 
striking 	JJ 
string 	NN 
striped 	VBD 
stripe 	NN 
strip 	NN 
stroke 	NN 
strong 	JJ 
strongly 	RB 
structure 	NN 
struggle 	NN 
student 	NN 
studio 	NN 
study 	NN 
stuff 	NN 
stupid 	JJ 
style 	NN 
subject 	JJ 
substance 	NN 
substantial 	JJ 
substantially 	RB 
substitute 	JJ 
substitute 	NN 
succeed 	VB 
successful 	JJ 
successfully 	RB 
success 	NN 
such 	JJ 
suck 	NN 
sudden 	JJ 
suddenly 	RB 
suffering 	VBG 
suffer 	VBP 
sufficient 	JJ 
sufficiently 	RB 
sugar 	NN 
suggestion 	NN 
suggest 	VBP 
suitable 	JJ 
suit 	NN 
summary 	NN 
summer 	NN 
sum 	NN 
Sunday 	NNP 
sun 	NN 
superior 	JJ 
supermarket 	NN 
supply 	NN 
supporter 	NN 
support 	NN 
suppose 	VBP 
sure 	JJ 
surely 	RB 
surface 	NN 
surgery 	NN 
surprised 	VBD 
surprise 	NN 
surprising 	JJ 
surprisingly 	RB 
surroundings 	NNS 
surrounding 	VBG 
surround 	VBP 
survey 	NN 
survive 	VBP 
suspect 	JJ 
suspicion 	NN 
suspicious 	JJ 
swallow 	VB 
swear 	VB 
sweater 	NN 
sweat 	NN 
sweep 	NN 
sweet 	JJ 
swelling 	VBG 
swell 	NN 
swimming 	NN 
swim 	VBP 
swing 	NN 
switch 	NN 
swollen 	JJ 
symbol 	NN 
sympathetic 	JJ 
sympathy 	NN 
system 	NN 
table 	NN 
tablet 	NN 
tackle 	VB 
tackle 	VBP 
tail 	NN 
take 	VB 
tale 	NN 
talent 	NN 
talk 	NN 
tall 	JJ 
tank 	NN 
tape 	NN 
tap 	NN 
target 	NN 
task 	NN 
taste 	NN 
taxi 	NN 
tax 	NN 
teacher 	NN 
teaching 	NN 
teach 	VBP 
team 	NN 
tea 	NN 
tear 	VB 
technical 	JJ 
technique 	NN 
technology 	NN 
television 	NN 
tell 	VBP 
temperature 	NN 
temporarily 	RB 
temporary 	JJ 
tendency 	NN 
tend 	VB 
tension 	NN 
tent 	NN 
term 	NN 
terrible 	JJ 
terribly 	RB 
territory 	NN 
terrorism 	NN 
terrorist 	JJ 
terror 	NN 
test 	NN 
text 	NN 
than 	IN 
thanks 	NNS 
thank 	VBP 
theater 	NN 
the 	DT 
their 	PRP$ 
theirs 	JJ 
theme 	NN 
them 	PRP 
themselves 	PRP 
then 	RB 
theory 	NN 
therefore 	RB 
there 	RB 
they 	PRP 
thick 	JJ 
thickly 	RB 
thickness 	NN 
thief 	NN 
thing 	NN 
thin 	JJ 
thinking 	VBG 
think 	VB 
thirsty 	IN 
this 	DT 
thorough 	JJ 
thoroughly 	RB 
though 	IN 
though 	RB 
thought 	VBN 
thread 	NN 
threatening 	VBG 
threaten 	VBP 
threat 	NN 
throat 	NN 
through 	IN 
throughout 	IN 
throw 	VB 
thumb 	NN 
Thursday 	NNP 
thus 	RB 
ticket 	NN 
tie 	JJ 
tie 	NN 
tight 	JJ 
tightly 	RB 
tight 	RB 
till 	IN 
time 	NN 
timetable 	NN 
tin 	NN 
tiny 	JJ 
tip 	NN 
tired 	JJ 
tire 	NN 
tiring 	VBG 
title 	NN 
today 	NN 
toe 	NN 
together 	RB 
toilet 	NN 
tomato 	NN 
tomorrow 	NN 
tone 	NN 
tongue 	NN 
tonight 	NN 
ton 	NN 
tool 	NN 
too 	RB 
tooth 	NN 
topic 	NN 
top 	JJ 
top 	NN 
total 	JJ 
totally 	RB 
to 	TO 
touch 	NN 
tough 	JJ 
tourist 	NN 
tour 	NN 
toward 	IN 
towards 	IN 
towel 	NN 
tower 	NN 
town 	NN 
toy 	NN 
trace 	NN 
track 	NN 
trade 	NN 
traditional 	JJ 
traditionally 	RB 
tradition 	NN 
traffic 	NN 
training 	NN 
train 	NN 
transfer 	NN 
transform 	VB 
transition 	NN 
translate 	VB 
translation 	NN 
transparent 	JJ 
transportation 	NN 
transport 	NN 
trap 	NN 
trash 	NN 
traveler 	NN 
travel 	NN 
treatment 	NN 
treat 	NN 
tree 	NN 
trend 	NN 
trial 	NN 
triangle 	NN 
trick 	NN 
trip 	NN 
troop 	NN 
tropical 	JJ 
trouble 	NN 
truck 	NN 
true 	JJ 
truly 	RB 
trust 	NN 
truth 	NN 
try 	VBP 
tube 	NN 
Tuesday 	NNP 
tune 	NN 
tunnel 	NN 
turn 	NN 
turn 	VB 
TV 	NN 
twice 	RB 
twin 	JJ 
twisted 	JJ 
twist 	NN 
type 	NN 
typical 	JJ 
typically 	RB 
ugly 	JJ 
ultimate 	JJ 
ultimately 	RB 
umbrella 	NN 
unable 	JJ 
unacceptable 	JJ 
uncertain 	JJ 
uncle 	NN 
uncomfortable 	JJ 
unconscious 	JJ 
uncontrolled 	JJ 
underground 	JJ 
under 	IN 
underneath 	IN 
understanding 	VBG 
understand 	VB 
underwater 	JJ 
underwear 	NN 
undo 	VBP 
unemployed 	JJ 
unemployment 	NN 
unexpected 	JJ 
unexpectedly 	RB 
unfair 	JJ 
unfairly 	RB 
unfortunate 	JJ 
unfortunately 	RB 
unfriendly 	JJ 
unhappiness 	NN 
unhappy 	JJ 
uniform 	JJ 
unimportant 	JJ 
union 	NN 
unique 	JJ 
united 	JJ 
unite 	VB 
unit 	NN 
universal 	JJ 
universe 	NN 
university 	NN 
unkind 	JJ 
unknown 	JJ 
unless 	IN 
unlike 	IN 
unlikely 	JJ 
unload 	VBP 
unlucky 	JJ 
unnecessary 	JJ 
unpleasant 	JJ 
unreasonable 	JJ 
unsteady 	JJ 
unsuccessful 	JJ 
until 	IN 
unusual 	JJ 
unusually 	RB 
unwilling 	JJ 
unwillingly 	RB 
up 	IN 
upon 	IN 
upper 	JJ 
upset 	JJ 
upside 	NN 
upstairs 	NN 
upward 	JJ 
upward 	RB 
upwards 	NNS 
urban 	JJ 
urge 	NN 
urgent 	JJ 
used 	VBN 
useful 	JJ 
useless 	JJ 
use 	NN 
user 	NN 
use 	VBP 
us 	PRP 
usual 	JJ 
usually 	RB 
vacation 	NN 
valid 	JJ 
valley 	NN 
valuable 	JJ 
value 	NN 
van 	NN 
variation 	NN 
varied 	VBD 
variety 	NN 
various 	JJ 
vary 	VBP 
vast 	JJ 
vegetable 	NN 
vehicle 	NN 
venture 	NN 
version 	NN 
vertical 	JJ 
very 	RB 
via 	IN 
victim 	NN 
victory 	NN 
video 	NN 
view 	NN 
view 	VBP 
violence 	NN 
violent 	JJ 
violently 	RB 
virtually 	RB 
virus 	NN 
visible 	JJ 
vision 	NN 
visit 	NN 
visitor 	NN 
vital 	JJ 
vmedical 	JJ 
vocabulary 	NN 
voice 	NN 
volume 	NN 
vote 	NN 
wage 	NN 
waist 	NN 
waiter 	NN 
waitress 	NN 
wait 	VB 
wake 	NN 
walking 	VBG 
walk 	NN 
wallet 	NN 
wall 	NN 
wander 	VBP 
want 	VBP 
warm 	JJ 
warmth 	NN 
warning 	NN 
war 	NN 
warn 	VBP 
wash 	NN 
waste 	NN 
watch 	NN 
water 	NN 
wave 	NN 
way 	NN 
weak 	JJ 
weakness 	NN 
wealth 	NN 
weapon 	NN 
wear 	NN 
weather 	NN 
web 	NN 
Web 	NN 
website 	NN 
wedding 	NN 
Wednesday 	NNP 
weekend 	NN 
weekly 	JJ 
week 	NN 
weight 	NN 
weigh 	VBP 
weird 	JJ 
welcome 	JJ 
well 	RB 
we 	PRP 
western 	JJ 
west 	JJ 
west 	NN 
west 	RB 
wet 	JJ 
whatever 	WDT 
what 	WDT 
what 	WP 
wheel 	NN 
whenever 	WRB 
when 	WRB 
whereas 	IN 
wherever 	WRB 
where 	WRB 
whether 	IN 
which 	WDT 
while 	IN 
whisper 	NN 
whistle 	VBP 
white 	JJ 
whoever 	WP 
whole 	JJ 
whom 	WP 
whose 	WP$ 
who 	WP 
why 	WRB 
wide 	JJ 
widely 	RB 
width 	NN 
wife 	NN 
wild 	JJ 
wildly 	RB 
willing 	JJ 
willingly 	RB 
willingness 	NN 
will 	MD 
wind 	NN 
window 	NN 
wind 	VB 
wine 	NN 
wing 	NN 
winner 	NN 
winning 	VBG 
winter 	NN 
win 	VBP 
wire 	NN 
wise 	JJ 
wish 	NN 
withdraw 	VBP 
with 	IN 
within 	IN 
without 	IN 
witness 	NN 
woman 	NN 
wonderful 	JJ 
wonder 	NN 
wooden 	JJ 
wood 	NN 
wool 	NN 
word 	NN 
worker 	NN 
working 	VBG 
work 	NN 
world 	NN 
worried 	JJ 
worrying 	JJ 
worry 	NN 
worship 	NN 
worth 	NN 
would 	MD 
wounded 	VBD 
wound 	NN 
wrap 	NN 
wrist 	NN 
writer 	NN 
write 	VB 
writing 	VBG 
written 	VBN 
wrong 	JJ 
wrongly 	RB 
yard 	NN 
yawn 	JJ 
yawn 	NN 
yeah 	NN 
year 	NN 
yellow 	JJ 
yesterday 	NN 
yes 	UH 
yet 	RB 
young 	JJ 
you 	PRP 
your 	PRP$ 
yourself 	PRP 
yours 	PRP$ 
youth 	NN 
zero 	CD 
zone 	NN
