I	NN
you	PRP
this	DT
who	WP
what	WDT
one	CD
two	CD
fish	NN
dog	NN
louse	NN
blood	NN
bone	NN
egg	NN
horn	NN
tail	NN
ear	NN
eye	NN
nose	NN
tooth	NN
tongue	NN
hand	NN
know	VB
die	VB
give	VB
sun	NN
moon	NN
water	NN
salt	NN
stone	NN
wind	NN
fire	NN
year	NN
full	JJ
new	JJ
name	NN
