the	DT
be	VB
and	CC
of	IN
a	DT
in	IN
to	TO
have	VB
to	IN
it	PRP
I	PRP
that	CC
for	IN
you	PRP
he	PRP
with	IN
on	IN
do	VB
say	VB
this	DT
they	PRP
at	IN
but	CC
we	PRP
his	PRP$
from	IN
that	DT
not	RB
n't	RB
by	IN
she	PRP
or	CC
as	CC
what	DT
go	VB
their	PRP$
can	VB
who	WP
get	VB
if	CC
would	VB
her	PRP$
all	DT
my	PRP$
make	VB
about	IN
know	VB
will	VB
as	IN
up	RB
one	CD
time	NN
there	EX
year	NN
so	RB
think	VB
when	CC
which	DT
them	PRP
some	DT
me	PRP
people	NN
take	VB
out	RB
into	IN
just	RB
see	VB
him	PRP
your	PRP$
come	VB
could	VB
now	RB
than	CC
like	IN
other	JJ
how	RB
then	RB
its	PRP$
our	PRP$
two	CD
more	RB
these	DT
want	VB
way	NN
look	VB
first	JJ
also	RB
new	JJ
because	CC
day	NN
more	DT
use	VB
no	DT
man	NN
find	VB
here	RB
thing	NN
give	VB
many	DT
well	RB
only	RB
those	DT
tell	VB
one	NN
very	RB
her	PRP
even	RB
back	RB
any	DT
good	JJ
woman	NN
through	IN
us	PRP
life	NN
child	NN
there	RB
work	VB
down	RB
may	VB
after	IN
should	VB
call	VB
world	NN
over	IN
school	NN
still	RB
try	VB
in	RB
as	RB
last	JJ
ask	VB
need	VB
too	RB
feel	VB
three	CD
when	RB
state	NN
never	RB
become	VB
between	IN
high	JJ
really	RB
something	NN
most	RB
another	DT
much	DT
family	NN
own	DT
out	IN
leave	VB
put	VB
old	JJ
while	CC
mean	VB
on	RB
keep	VB
student	NN
why	RB
let	VB
great	JJ
same	DT
big	JJ
group	NN
begin	VB
seem	VB
country	NN
help	VB
talk	VB
where	CC
turn	VB
problem	NN
every	DT
start	VB
hand	NN
might	VB
American	JJ
show	VB
part	NN
about	RB
against	IN
place	NN
over	RB
such	DT
again	RB
few	DT
case	NN
most	DT
week	NN
company	NN
where	RB
system	NN
each	DT
right	RB
program	NN
hear	VB
so	CC
question	NN
during	IN
work	NN
play	VB
government	NN
run	VB
small	JJ
number	NN
off	RB
always	RB
move	VB
like	VB
night	NN
live	VB
Mr	NN
point	NN
believe	VB
hold	VB
today	RB
bring	VB
happen	VB
next	JJ
without	IN
before	IN
large	JJ
all	RB
million	CD
must	VB
home	NN
under	IN
water	NN
room	NN
write	VB
mother	NN
area	NN
national	JJ
money	NN
story	NN
young	JJ
fact	NN
month	NN
different	JJ
lot	NN
right	NN
study	NN
book	NN
eye	NN
job	NN
word	NN
though	CC
business	NN
issue	NN
side	NN
kind	NN
four	CD
head	NN
far	RB
black	JJ
long	JJ
both	DT
little	JJ
house	NN
yes	UH
after	CC
since	CC
long	RB
provide	VB
service	NN
around	IN
friend	NN
important	JJ
father	NN
sit	VB
away	RB
until	CC
power	NN
hour	NN
game	NN
often	RB
yet	RB
line	NN
political	JJ
end	NN
among	IN
ever	RB
stand	VB
bad	JJ
lose	VB
however	RB
member	NN
pay	VB
law	NN
meet	VB
car	NN
city	NN
almost	RB
include	VB
continue	VB
set	VB
later	RB
community	NN
much	RB
name	NN
five	CD
once	RB
white	JJ
least	RB
president	NN
learn	VB
real	JJ
change	VB
team	NN
minute	NN
best	JJ
several	DT
idea	NN
kid	NN
body	NN
information	NN
nothing	NN
ago	RB
right	JJ
lead	VB
social	JJ
understand	VB
whether	CC
back	NN
watch	VB
together	RB
follow	VB
around	RB
parent	NN
only	JJ
stop	VB
face	NN
anything	PRP
create	VB
public	JJ
already	RB
speak	VB
others	NN
read	VB
level	NN
allow	VB
add	VB
office	NN
spend	VB
door	NN
health	NN
person	NN
art	NN
sure	JJ
such	IN
war	NN
history	NN
party	NN
within	IN
grow	VB
result	NN
open	VB
change	NN
morning	NN
walk	VB
reason	NN
low	JJ
win	VB
research	NN
girl	NN
guy	NN
early	JJ
food	NN
before	CC
moment	NN
himself	PRP
air	NN
teacher	NN
force	NN
offer	VB
enough	RB
both	RB
education	NN
across	IN
although	CC
remember	VB
foot	NN
second	JJ
boy	NN
maybe	RB
toward	IN
able	JJ
age	NN
off	IN
policy	NN
everything	NN
love	VB
process	NN
music	NN
including	IN
consider	VB
appear	VB
actually	RB
buy	VB
probably	RB
human	JJ
wait	VB
serve	VB
market	NN
die	VB
send	VB
expect	VB
home	RB
sense	NN
build	VB
stay	VB
fall	VB
oh	UH
nation	NN
plan	NN
cut	VB
college	NN
interest	NN
death	NN
course	RB
someone	NN
experience	NN
behind	IN
reach	VB
local	JJ
kill	VB
six	CD
remain	VB
effect	NN
use	NN
yeah	UH
suggest	VB
class	NN
control	NN
raise	VB
care	NN
perhaps	RB
little	RB
late	JJ
hard	JJ
field	NN
else	RB
pass	VB
former	DT
sell	VB
major	JJ
sometimes	RB
require	VB
along	IN
development	NN
themselves	PRP
report	VB
role	NN
better	JJ
economic	JJ
effort	NN
up	IN
decide	VB
rate	NN
strong	JJ
possible	JJ
heart	NN
drug	NN
show	NN
leader	NN
light	NN
voice	NN
wife	NN
whole	JJ
police	NN
mind	NN
finally	RB
pull	VB
return	VB
free	JJ
military	JJ
price	NN
report	NN
less	RB
according	IN
decision	NN
explain	VB
son	NN
hope	VB
even	CC
develop	VB
view	NN
relationship	NN
carry	VB
town	NN
road	NN
drive	VB
arm	NN
true	JJ
federal	JJ
break	VB
better	RB
difference	NN
thank	VB
receive	VB
value	NN
international	JJ
building	NN
action	NN
full	JJ
model	NN
join	VB
season	NN
society	NN
because	IN
tax	NN
director	NN
early	RB
position	NN
player	NN
agree	VB
especially	RB
record	NN
pick	VB
wear	VB
paper	NN
special	JJ
space	NN
ground	NN
form	NN
support	VB
event	NN
official	NN
whose	DT
matter	NN
everyone	NN
center	NN
couple	NN
site	NN
end	VB
project	NN
hit	VB
base	VB
activity	NN
star	NN
table	NN
need	NN
court	NN
produce	VB
eat	VB
American	NN
teach	VB
oil	NN
half	DT
situation	NN
easy	JJ
cost	NN
industry	NN
figure	NN
face	VB
street	NN
image	NN
itself	PRP
phone	NN
either	RB
data	NN
cover	VB
quite	RB
picture	NN
clear	JJ
practice	NN
piece	NN
land	NN
recent	JJ
describe	VB
product	NN
doctor	NN
wall	NN
patient	NN
worker	NN
news	NN
test	NN
movie	NN
certain	JJ
north	NN
love	NN
personal	JJ
open	JJ
support	NN
simply	RB
third	JJ
technology	NN
catch	VB
step	NN
baby	NN
computer	NN
type	NN
attention	NN
draw	VB
film	NN
Republican	NN
tree	NN
source	NN
red	JJ
nearly	RB
organization	NN
choose	VB
cause	VB
hair	NN
look	NN
point	VB
century	NN
evidence	NN
window	NN
difficult	JJ
listen	VB
soon	RB
culture	NN
billion	CD
chance	NN
brother	NN
energy	NN
period	NN
course	NN
summer	NN
less	DT
realize	VB
hundred	CD
available	JJ
plant	NN
likely	JJ
opportunity	NN
term	NN
short	JJ
letter	NN
condition	NN
choice	NN
place	VB
single	JJ
rule	NN
daughter	NN
administration	NN
south	NN
husband	NN
Congress	NN
floor	NN
campaign	NN
material	NN
population	NN
well	IN
call	NN
economy	NN
medical	JJ
hospital	NN
church	NN
close	VB
thousand	CD
risk	NN
current	JJ
fire	NN
future	NN
wrong	JJ
involve	VB
defense	NN
anyone	NN
increase	VB
security	NN
bank	NN
myself	PRP
certainly	RB
west	NN
sport	NN
board	NN
seek	VB
per	IN
subject	NN
officer	NN
private	JJ
rest	NN
behavior	NN
deal	VB
performance	NN
fight	VB
throw	VB
top	NN
quickly	RB
past	JJ
goal	NN
second	NN
bed	NN
order	NN
author	NN
fill	VB
represent	VB
focus	VB
foreign	JJ
drop	VB
plan	VB
blood	NN
upon	IN
agency	NN
push	VB
nature	NN
color	NN
no	RB
recently	RB
store	NN
reduce	VB
sound	NN
note	VB
fine	JJ
before	RB
near	IN
movement	NN
page	NN
enter	VB
share	VB
than	IN
common	JJ
poor	JJ
other	JJ
natural	JJ
race	NN
concern	NN
series	NN
significant	JJ
similar	JJ
hot	JJ
language	NN
each	DT
usually	RB
response	NN
dead	JJ
rise	VB
animal	NN
factor	NN
decade	NN
article	NN
shoot	VB
east	NN
save	VB
seven	CD
artist	NN
away	IN
scene	NN
stock	NN
career	NN
despite	IN
central	JJ
eight	JJ
thus	RB
treatment	NN
beyond	IN
happy	JJ
exactly	RB
protect	VB
approach	NN
lie	VB
size	NN
dog	NN
fund	NN
serious	JJ
occur	VB
media	NN
ready	JJ
sign	NN
thought	NN
list	NN
individual	NN
simple	JJ
quality	NN
pressure	NN
accept	VB
answer	NN
hard	RB
resource	NN
identify	VB
left	JJ
meeting	NN
determine	VB
prepare	VB
disease	NN
whatever	DT
success	NN
argue	VB
cup	NN
particularly	RB
amount	NN
ability	NN
staff	NN
recognize	VB
indicate	VB
character	NN
growth	NN
loss	NN
degree	NN
wonder	VB
attack	NN
herself	PRP
region	NN
television	NN
box	NN
TV	NN
training	NN
pretty	RB
trade	NN
deal	NN
election	NN
everybody	NN
physical	JJ
lay	VB
general	JJ
feeling	NN
standard	NN
bill	NN
message	NN
fail	VB
outside	IN
arrive	VB
analysis	NN
benefit	NN
name	VB
sex	NN
forward	RB
lawyer	NN
present	VB
section	NN
environmental	JJ
glass	NN
answer	VB
skill	NN
sister	NN
PM	RB
professor	NN
operation	NN
financial	JJ
crime	NN
stage	NN
ok	RB
compare	VB
authority	NN
miss	VB
design	NN
sort	NN
one	NN
act	VB
ten	CD
knowledge	NN
gun	NN
station	NN
blue	JJ
state	VB
strategy	NN
little	DT
clearly	RB
discuss	VB
indeed	RB
force	VB
truth	NN
song	NN
example	NN
democratic	JJ
check	VB
environment	NN
leg	NN
dark	JJ
public	NN
various	JJ
rather	RB
laugh	VB
guess	VB
executive	NN
set	NN
study	VB
prove	VB
hang	VB
entire	JJ
rock	NN
design	VB
enough	DT
forget	VB
since	IN
claim	VB
note	NN
remove	VB
manager	NN
help	NN
close	JJ
sound	VB
enjoy	VB
network	NN
legal	JJ
religious	JJ
cold	JJ
form	VB
final	JJ
main	JJ
science	NN
green	JJ
memory	NN
card	NN
above	IN
seat	NN
cell	NN
establish	VB
nice	JJ
trial	NN
expert	NN
that	RB
spring	NN
firm	NN
Democrat	NN
radio	NN
visit	VB
management	NN
care	VB
avoid	VB
imagine	VB
tonight	RB
huge	JJ
ball	NN
no	UH
close	RB
finish	VB
yourself	PRP
talk	NN
theory	NN
impact	NN
respond	VB
statement	NN
maintain	VB
charge	NN
popular	JJ
traditional	JJ
onto	IN
reveal	VB
direction	NN
weapon	NN
employee	NN
cultural	JJ
contain	VB
peace	NN
head	VB
control	VB
base	NN
pain	NN
apply	VB
play	NN
measure	NN
wide	JJ
shake	VB
fly	VB
interview	NN
manage	VB
chair	NN
fish	NN
particular	JJ
camera	NN
structure	NN
politics	NN
perform	VB
bit	NN
weight	NN
suddenly	RB
discover	VB
candidate	NN
top	JJ
production	NN
treat	VB
trip	NN
evening	NN
affect	VB
inside	IN
conference	NN
unit	NN
best	RB
style	NN
adult	NN
worry	VB
range	NN
mention	VB
rather	IN
far	JJ
deep	JJ
past	NN
edge	NN
individual	JJ
specific	JJ
writer	NN
trouble	NN
necessary	JJ
throughout	IN
challenge	NN
fear	NN
shoulder	NN
institution	NN
middle	JJ
sea	NN
dream	NN
bar	NN
beautiful	JJ
property	NN
instead	RB
improve	VB
stuff	NN
detail	NN
method	NN
sign	VB
somebody	NN
magazine	NN
hotel	NN
soldier	NN
reflect	VB
heavy	JJ
sexual	JJ
cause	NN
bag	NN
heat	NN
fall	NN
marriage	NN
tough	JJ
sing	VB
surface	NN
purpose	NN
exist	VB
pattern	NN
whom	WP
skin	NN
agent	NN
owner	NN
machine	NN
gas	NN
down	IN
ahead	RB
generation	NN
commercial	JJ
address	VB
cancer	NN
test	VB
item	NN
reality	NN
coach	NN
step	VB
Mrs	NN
yard	NN
beat	VB
violence	NN
total	JJ
tend	VB
investment	NN
discussion	NN
finger	NN
garden	NN
notice	VB
collection	NN
modern	JJ
task	NN
partner	NN
positive	JJ
civil	JJ
kitchen	NN
consumer	NN
shot	NN
budget	NN
wish	VB
painting	NN
scientist	NN
safe	JJ
agreement	NN
capital	NN
mouth	NN
nor	CC
victim	NN
newspaper	NN
instead	IN
threat	NN
responsibility	NN
smile	VB
attorney	NN
score	NN
account	NN
interesting	JJ
break	NN
audience	NN
rich	JJ
dinner	NN
figure	VB
vote	NN
western	JJ
relate	VB
travel	VB
debate	NN
prevent	VB
citizen	NN
majority	NN
none	NN
front	IN
born	VB
admit	VB
senior	JJ
assume	VB
wind	NN
key	JJ
professional	JJ
mission	NN
fast	RB
alone	RB
customer	NN
suffer	VB
speech	NN
successful	JJ
option	NN
participant	NN
southern	JJ
fresh	JJ
eventually	RB
no	RB
forest	NN
video	NN
global	JJ
Senate	NN
reform	NN
access	NN
restaurant	NN
judge	NN
publish	VB
cost	VB
relation	NN
like	CC
release	VB
own	VB
bird	NN
opinion	NN
credit	NN
critical	JJ
corner	NN
concerned	JJ
recall	VB
version	NN
stare	VB
safety	NN
effective	JJ
neighborhood	NN
original	JJ
act	NN
troop	NN
income	NN
directly	RB
hurt	VB
species	NN
immediately	RB
track	NN
basic	JJ
strike	VB
hope	NN
sky	NN
freedom	NN
absolutely	RB
plane	NN
nobody	NN
achieve	VB
object	NN
attitude	NN
labor	NN
refer	VB
concept	NN
client	NN
powerful	JJ
perfect	JJ
nine	CD
therefore	RB
conduct	VB
announce	VB
conversation	NN
examine	VB
touch	VB
please	RB
attend	VB
completely	RB
vote	VB
variety	NN
sleep	VB
turn	NN
involved	JJ
investigation	NN
nuclear	JJ
researcher	NN
press	NN
conflict	NN
spirit	NN
experience	VB
replace	VB
British	JJ
encourage	VB
argument	NN
by	RB
once	CC
camp	NN
brain	NN
feature	NN
afternoon	NN
AM	RB
weekend	NN
dozen	CD
possibility	NN
along	RB
insurance	NN
department	NN
battle	NN
beginning	NN
date	NN
generally	RB
African	JJ
very	JJ
sorry	JJ
crisis	NN
complete	VB
fan	NN
stick	VB
define	VB
easily	RB
through	RB
hole	NN
element	NN
vision	NN
status	NN
normal	JJ
Chinese	JJ
ship	NN
solution	NN
stone	NN
slowly	RB
scale	NN
bit	RB
university	NN
introduce	VB
driver	NN
attempt	NN
park	NN
spot	NN
lack	NN
ice	NN
boat	NN
drink	VB
sun	NN
front	JJ
distance	NN
wood	NN
handle	VB
truck	NN
return	NN
mountain	NN
survey	NN
supposed	JJ
tradition	NN
winter	NN
village	NN
Soviet	JJ
refuse	VB
sales	NN
roll	VB
communication	NN
run	NN
screen	NN
gain	VB
resident	NN
hide	VB
gold	NN
club	NN
future	JJ
farm	NN
potential	JJ
increase	NN
middle	NN
European	JJ
presence	NN
independent	JJ
district	NN
shape	NN
reader	NN
Ms	NN
contract	NN
crowd	NN
Christian	JJ
express	VB
apartment	NN
willing	JJ
strength	NN
previous	JJ
band	NN
obviously	RB
horse	NN
interested	JJ
target	NN
prison	NN
ride	VB
guard	NN
terms	IN
demand	NN
reporter	NN
deliver	VB
text	NN
share	NN
tool	NN
wild	JJ
vehicle	NN
observe	VB
flight	NN
inside	RB
facility	NN
understanding	NN
average	JJ
emerge	VB
advantage	NN
quick	JJ
light	JJ
leadership	NN
earn	VB
pound	NN
basis	NN
bright	JJ
operate	VB
guest	NN
sample	NN
contribute	VB
tiny	JJ
block	NN
protection	NN
settle	VB
feed	VB
collect	VB
additional	JJ
while	NN
highly	RB
identity	NN
title	NN
mostly	RB
lesson	NN
faith	NN
river	NN
promote	VB
living	NN
present	JJ
count	VB
unless	CC
marry	VB
tomorrow	RB
technique	NN
path	NN
ear	NN
shop	NN
folk	NN
order	VB
principle	NN
survive	VB
lift	VB
border	NN
competition	NN
jump	VB
gather	VB
limit	VB
fit	VB
claim	NN
cry	VB
equipment	NN
worth	IN
associate	VB
critic	NN
warm	JJ
aspect	NN
result	VB
insist	VB
failure	NN
annual	JJ
French	JJ
Christmas	NN
comment	NN
responsible	JJ
affair	NN
approach	VB
until	IN
procedure	NN
regular	JJ
spread	VB
chairman	NN
baseball	NN
soft	JJ
ignore	VB
egg	NN
measure	VB
belief	NN
demonstrate	VB
anybody	NN
murder	NN
gift	NN
religion	NN
review	NN
editor	NN
past	IN
engage	VB
coffee	NN
document	NN
speed	NN
cross	VB
influence	NN
anyway	RB
threaten	VB
commit	VB
female	JJ
youth	NN
wave	NN
move	NN
afraid	JJ
quarter	NN
background	NN
native	JJ
broad	JJ
wonderful	JJ
deny	VB
apparently	RB
slightly	RB
reaction	NN
twice	RB
suit	NN
perspective	NN
growing	JJ
blow	VB
construction	NN
kind	RB
intelligence	NN
destroy	VB
cook	VB
connection	NN
charge	VB
burn	VB
shoe	NN
view	VB
grade	NN
context	NN
committee	NN
hey	UH
mistake	NN
focus	NN
smile	NN
location	NN
clothes	NN
Indian	JJ
quiet	JJ
dress	VB
promise	VB
aware	JJ
neighbor	NN
complete	JJ
drive	NN
function	NN
bone	NN
active	JJ
extend	VB
chief	JJ
average	NN
combine	VB
wine	NN
below	RB
cool	JJ
voter	NN
mean	NN
demand	VB
learning	NN
bus	NN
hell	NN
dangerous	JJ
remind	VB
moral	JJ
United	JJ
category	NN
relatively	RB
victory	NN
key	NN
academic	JJ
visit	NN
Internet	NN
healthy	JJ
fire	VB
negative	JJ
following	JJ
historical	JJ
medicine	NN
tour	NN
depend	VB
photo	NN
finding	NN
grab	VB
direct	JJ
classroom	NN
contact	NN
justice	NN
participate	VB
daily	JJ
fair	JJ
pair	NN
famous	JJ
exercise	NN
knee	NN
flower	NN
tape	NN
hire	VB
familiar	JJ
appropriate	JJ
supply	NN
fully	RB
cut	NN
will	NN
actor	NN
birth	NN
search	NN
tie	VB
democracy	NN
eastern	JJ
primary	JJ
yesterday	RB
circle	NN
device	NN
progress	NN
next	IN
front	NN
bottom	NN
island	NN
exchange	NN
clean	JJ
studio	NN
train	VB
lady	NN
colleague	NN
application	NN
neck	NN
lean	VB
damage	NN
plastic	NN
tall	JJ
plate	NN
hate	VB
otherwise	RB
writing	NN
press	VB
male	JJ
start	NN
alive	JJ
expression	NN
football	NN
intend	VB
attack	VB
chicken	NN
army	NN
abuse	NN
theater	NN
shut	VB
map	NN
extra	JJ
session	NN
danger	NN
welcome	VB
domestic	JJ
lots	NNS
literature	NN
rain	NN
desire	NN
assessment	NN
injury	NN
respect	NN
northern	JJ
nod	VB
paint	VB
fuel	NN
leaf	NN
direct	VB
dry	JJ
Russian	JJ
instruction	NN
fight	NN
pool	NN
climb	VB
sweet	JJ
lead	NN
engine	NN
fourth	JJ
salt	NN
expand	VB
importance	NN
metal	NN
fat	NN
ticket	NN
software	NN
disappear	VB
corporate	JJ
strange	JJ
lip	NN
reading	NN
urban	JJ
mental	JJ
increasingly	RB
lunch	NN
educational	JJ
somewhere	RB
farmer	NN
above	RB
sugar	NN
planet	NN
favorite	JJ
explore	VB
obtain	VB
enemy	NN
greatest	JJ
complex	JJ
surround	VB
athlete	NN
invite	VB
repeat	VB
carefully	RB
soul	NN
scientific	JJ
impossible	JJ
panel	NN
meaning	NN
mom	NN
married	JJ
alone	JJ
instrument	NN
predict	VB
weather	NN
presidential	JJ
emotional	JJ
commitment	NN
Supreme	JJ
bear	VB
pocket	NN
thin	JJ
temperature	NN
surprise	NN
poll	NN
proposal	NN
consequence	NN
half	NN
breath	NN
sight	NN
cover	NN
balance	NN
adopt	VB
minority	NN
straight	RB
attempt	VB
connect	VB
works	NN
teaching	NN
belong	VB
aid	NN
advice	NN
okay	RB
photograph	NN
empty	JJ
regional	JJ
trail	NN
novel	NN
code	NN
somehow	RB
organize	VB
jury	NN
breast	NN
Iraqi	JJ
human	NN
acknowledge	VB
theme	NN
storm	NN
union	NN
record	VB
desk	NN
fear	VB
thanks	NN
fruit	NN
under	RB
expensive	JJ
yellow	JJ
conclusion	NN
prime	JJ
shadow	NN
struggle	VB
conclude	VB
analyst	NN
dance	NN
limit	NN
like	JJ
regulation	NN
being	NN
last	VB
ring	NN
largely	RB
shift	VB
revenue	NN
mark	VB
locate	VB
county	NN
appearance	NN
package	NN
difficulty	NN
bridge	NN
recommend	VB
obvious	JJ
train	NN
basically	RB
e-mail	NN
generate	VB
anymore	RB
propose	VB
thinking	NN
possibly	RB
trend	NN
visitor	NN
loan	NN
currently	RB
comfortable	JJ
investor	NN
but	IN
profit	NN
angry	JJ
crew	NN
deep	RB
accident	NN
male	NN
meal	NN
hearing	NN
traffic	NN
muscle	NN
notion	NN
capture	VB
prefer	VB
truly	RB
earth	NN
Japanese	JJ
chest	NN
search	VB
thick	JJ
cash	NN
museum	NN
beauty	NN
emergency	NN
unique	JJ
feature	VB
internal	JJ
ethnic	JJ
link	VB
stress	NN
content	NN
select	VB
root	NN
nose	NN
declare	VB
outside	RB
appreciate	VB
actual	JJ
bottle	NN
hardly	RB
setting	NN
launch	VB
dress	NN
file	NN
sick	JJ
outcome	NN
ad	NN
defend	VB
matter	VB
judge	VB
duty	NN
sheet	NN
ought	VB
ensure	VB
Catholic	JJ
extremely	RB
extent	NN
component	NN
mix	VB
long-term	JJ
slow	JJ
contrast	NN
zone	NN
wake	VB
challenge	VB
airport	NN
chief	NN
brown	JJ
standard	JJ
shirt	NN
pilot	NN
warn	VB
ultimately	RB
cat	NN
contribution	NN
capacity	NN
ourselves	PRP
estate	NN
guide	NN
circumstance	NN
snow	NN
English	JJ
politician	NN
steal	VB
pursue	VB
slip	VB
percentage	NN
meat	NN
funny	JJ
neither	RB
soil	NN
influence	VB
surgery	NN
correct	JJ
Jewish	JJ
blame	VB
estimate	VB
due	IN
basketball	NN
late	RB
golf	NN
investigate	VB
crazy	JJ
significantly	RB
chain	NN
address	NN
branch	NN
combination	NN
just	JJ
frequently	RB
governor	NN
relief	NN
user	NN
dad	NN
kick	VB
part	RB
manner	NN
ancient	JJ
silence	NN
rating	NN
golden	JJ
motion	NN
German	JJ
gender	NN
solve	VB
fee	NN
landscape	NN
used	JJ
bowl	NN
equal	JJ
long	CC
official	JJ
forth	RB
frame	NN
typical	JJ
except	IN
conservative	JJ
eliminate	VB
host	NN
hall	NN
trust	VB
ocean	NN
score	VB
row	NN
producer	NN
afford	VB
meanwhile	RB
regime	NN
division	NN
confirm	VB
fix	VB
appeal	NN
mirror	NN
tooth	NN
smart	JJ
length	NN
entirely	RB
rely	VB
topic	NN
complain	VB
issue	VB
variable	NN
back	VB
range	VB
telephone	NN
perception	NN
attract	VB
confidence	NN
bedroom	NN
secret	NN
debt	NN
rare	JJ
his	PRP
tank	NN
nurse	NN
coverage	NN
opposition	NN
aside	RB
anywhere	RB
bond	NN
file	VB
pleasure	NN
master	NN
era	NN
requirement	NN
check	NN
stand	NN
fun	NN
expectation	NN
wing	NN
separate	JJ
now	CC
clear	VB
struggle	NN
mean	JJ
somewhat	RB
pour	VB
stir	VB
judgment	NN
clean	VB
except	CC
beer	NN
English	NN
reference	NN
tear	NN
doubt	NN
grant	VB
seriously	RB
account	VB
minister	NN
totally	RB
hero	NN
industrial	JJ
cloud	NN
stretch	VB
winner	NN
volume	NN
travel	NN
seed	NN
surprised	JJ
rest	VB
fashion	NN
pepper	NN
separate	VB
busy	JJ
intervention	NN
copy	NN
tip	NN
below	IN
cheap	JJ
aim	VB
cite	VB
welfare	NN
vegetable	NN
gray	JJ
dish	NN
beach	NN
improvement	NN
everywhere	RB
opening	NN
overall	JJ
divide	VB
initial	JJ
terrible	JJ
oppose	VB
contemporary	JJ
route	NN
multiple	JJ
essential	JJ
question	VB
league	NN
criminal	JJ
careful	JJ
core	NN
upper	JJ
rush	VB
necessarily	RB
specifically	RB
tired	JJ
rise	NN
tie	NN
employ	VB
holiday	NN
dance	VB
vast	JJ
resolution	NN
household	NN
fewer	DT
abortion	NN
apart	RB
witness	NN
match	VB
barely	RB
sector	NN
representative	NN
lack	VB
beneath	IN
beside	IN
black	NN
incident	NN
limited	JJ
proud	JJ
flow	NN
faculty	NN
increased	JJ
waste	NN
merely	RB
mass	NN
emphasize	VB
experiment	NN
definitely	RB
bomb	NN
enormous	JJ
tone	NN
liberal	JJ
massive	JJ
engineer	NN
wheel	NN
female	NN
decline	VB
invest	VB
promise	NN
cable	NN
towards	IN
expose	VB
rural	JJ
AIDS	NN
Jew	NN
narrow	JJ
cream	NN
secretary	NN
gate	NN
solid	JJ
hill	NN
typically	RB
noise	NN
grass	NN
unfortunately	RB
hat	NN
legislation	NN
succeed	VB
either	DT
celebrate	VB
achievement	NN
fishing	NN
drink	NN
accuse	VB
hand	VB
useful	JJ
land	VB
secret	JJ
reject	VB
talent	NN
taste	NN
characteristic	NN
milk	NN
escape	VB
cast	VB
sentence	NN
unusual	JJ
closely	RB
convince	VB
height	NN
physician	NN
assess	VB
sleep	NN
plenty	RB
ride	NN
virtually	RB
first	RB
addition	IN
sharp	JJ
creative	JJ
lower	VB
behind	RB
approve	VB
explanation	NN
outside	JJ
gay	JJ
campus	NN
proper	JJ
live	JJ
guilty	JJ
living	JJ
acquire	VB
compete	VB
technical	JJ
plus	IN
mind	VB
potential	NN
immigrant	NN
weak	JJ
illegal	JJ
hi	UH
alternative	NN
interaction	NN
column	NN
personality	NN
signal	NN
curriculum	NN
list	VB
honor	NN
passenger	NN
assistance	NN
forever	RB
fun	JJ
regard	VB
Israeli	JJ
association	NN
twenty	CD
knock	VB
review	VB
wrap	VB
lab	NN
offer	NN
display	VB
criticism	NN
asset	NN
depression	NN
spiritual	JJ
musical	JJ
journalist	NN
prayer	NN
suspect	VB
scholar	NN
warning	NN
climate	NN
cheese	NN
observation	NN
childhood	NN
payment	NN
sir	NN
permit	VB
cigarette	NN
definition	NN
priority	NN
bread	NN
creation	NN
graduate	NN
request	NN
emotion	NN
scream	VB
dramatic	JJ
universe	NN
gap	NN
excellent	JJ
deeply	RB
prosecutor	NN
mark	NN
green	NN
lucky	JJ
drag	VB
airline	NN
library	NN
agenda	NN
recover	VB
factory	NN
selection	NN
primarily	RB
roof	NN
unable	JJ
expense	NN
initiative	NN
diet	NN
arrest	VB
funding	NN
therapy	NN
wash	VB
schedule	NN
sad	JJ
brief	JJ
housing	NN
post	NN
purchase	VB
existing	JJ
dark	NN
steel	NN
regarding	IN
shout	VB
remaining	JJ
visual	JJ
fairly	RB
chip	NN
violent	JJ
silent	JJ
suppose	VB
self	NN
bike	NN
tea	NN
perceive	VB
comparison	NN
settlement	NN
layer	NN
planning	NN
far	CC
description	NN
later	JJ
slow	VB
slide	VB
widely	RB
wedding	NN
inform	VB
portion	NN
territory	NN
immediate	JJ
opponent	NN
abandon	VB
link	NN
mass	JJ
lake	NN
transform	VB
tension	NN
display	NN
leading	JJ
bother	VB
consist	VB
alcohol	NN
enable	VB
bend	VB
saving	NN
gain	NN
desert	NN
shall	VB
error	NN
release	NN
cop	NN
Arab	JJ
double	JJ
walk	NN
sand	NN
Spanish	JJ
rule	VB
hit	NN
print	NN
preserve	VB
passage	NN
formal	JJ
transition	NN
existence	NN
album	NN
participation	NN
arrange	VB
atmosphere	NN
joint	JJ
reply	VB
cycle	NN
opposite	JJ
lock	VB
whole	NN
deserve	VB
consistent	JJ
resistance	NN
discovery	NN
tear	VB
exposure	NN
pose	VB
stream	NN
sale	NN
trust	NN
benefit	VB
pot	NN
grand	JJ
mine	PRP$
hello	UH
coalition	NN
tale	NN
knife	NN
resolve	VB
racial	JJ
phase	NN
present	NN
joke	NN
coat	NN
Mexican	JJ
symptom	NN
contact	VB
manufacturer	NN
philosophy	NN
potato	NN
interview	VB
foundation	NN
quote	VB
online	JJ
pass	NN
negotiation	NN
good	NN
urge	VB
occasion	NN
dust	NN
breathe	VB
elect	VB
investigator	NN
jacket	NN
glad	JJ
ordinary	JJ
reduction	NN
rarely	RB
shift	NN
pack	VB
suicide	NN
numerous	JJ
touch	NN
substance	NN
discipline	NN
elsewhere	RB
iron	NN
practical	JJ
moreover	RB
passion	NN
volunteer	NN
implement	VB
essentially	RB
gene	NN
enforcement	NN
vs	IN
sauce	NN
independence	NN
marketing	NN
priest	NN
amazing	JJ
intense	JJ
advance	NN
employer	NN
shock	NN
inspire	VB
adjust	VB
retire	VB
sure	RB
visible	JJ
kiss	VB
illness	NN
cap	NN
habit	NN
competitive	JJ
juice	NN
congressional	JJ
involvement	NN
dominate	VB
previously	RB
whenever	RB
transfer	VB
analyze	VB
another	DT
attach	VB
for	CC
Indian	NN
disaster	NN
parking	NN
prospect	NN
boss	NN
complaint	NN
championship	NN
coach	VB
exercise	VB
fundamental	JJ
severe	JJ
enhance	VB
mystery	NN
impose	VB
poverty	NN
other	IN
entry	NN
fat	JJ
spending	NN
king	NN
evaluate	VB
symbol	NN
still	JJ
trade	VB
maker	NN
mood	NN
accomplish	VB
emphasis	NN
illustrate	VB
boot	NN
monitor	VB
Asian	JJ
entertainment	NN
bean	NN
evaluation	NN
creature	NN
commander	NN
digital	JJ
arrangement	NN
concentrate	VB
total	NN
usual	JJ
anger	NN
psychological	JJ
heavily	RB
peak	NN
approximately	RB
increasing	JJ
disorder	NN
missile	NN
equally	RB
vary	VB
wire	NN
round	NN
distribution	NN
transportation	NN
holy	JJ
ring	VB
twin	NN
command	NN
commission	NN
interpretation	NN
breakfast	NN
stop	NN
strongly	RB
engineering	NN
luck	NN
so-called	JJ
constant	JJ
race	VB
clinic	NN
veteran	NN
smell	VB
tablespoon	NN
capable	JJ
nervous	JJ
tourist	NN
light	VB
toss	VB
crucial	JJ
bury	VB
pray	VB
tomato	NN
exception	NN
butter	NN
deficit	NN
bathroom	NN
objective	NN
block	VB
electronic	JJ
ally	NN
journey	NN
reputation	NN
mixture	NN
surely	RB
tower	NN
smoke	NN
confront	VB
pure	JJ
glance	VB
dimension	NN
toy	NN
prisoner	NN
fellow	JJ
smooth	JJ
nearby	JJ
peer	NN
designer	NN
personnel	NN
shape	VB
educator	NN
relative	NN
immigration	NN
belt	NN
teaspoon	NN
birthday	NN
implication	NN
perfectly	RB
coast	NN
supporter	NN
accompany	VB
silver	NN
teenager	NN
recognition	NN
retirement	NN
flag	NN
recovery	NN
whisper	VB
watch	NN
gentleman	NN
corn	NN
moon	NN
inner	JJ
junior	JJ
rather	CC
throat	NN
salary	NN
swing	VB
observer	NN
due	JJ
straight	JJ
publication	NN
pretty	JJ
crop	NN
dig	VB
strike	NN
permanent	JJ
plant	VB
phenomenon	NN
anxiety	NN
unlike	IN
wet	JJ
literally	RB
resist	VB
convention	NN
embrace	VB
supply	VB
assist	VB
exhibition	NN
construct	VB
viewer	NN
pan	NN
consultant	NN
soon	CC
line	VB
administrator	NN
date	VB
occasionally	RB
mayor	NN
consideration	NN
CEO	NN
secure	VB
pink	JJ
smoke	VB
estimate	NN
buck	NN
historic	JJ
poem	NN
grandmother	NN
bind	VB
fifth	JJ
constantly	RB
enterprise	NN
favor	VB
testing	NN
stomach	NN
apparent	JJ
weigh	VB
install	VB
sensitive	JJ
suggestion	NN
mail	NN
recipe	NN
reasonable	JJ
preparation	NN
wooden	JJ
elementary	JJ
concert	NN
aggressive	JJ
false	JJ
intention	NN
channel	NN
extreme	JJ
tube	NN
drawing	NN
protein	NN
quit	VB
absence	NN
roll	NN
Latin	JJ
rapidly	RB
jail	NN
comment	VB
diversity	NN
honest	JJ
Palestinian	JJ
pace	NN
employment	NN
speaker	NN
impression	NN
essay	NN
respondent	NN
giant	JJ
cake	NN
historian	NN
negotiate	VB
restore	VB
substantial	JJ
pop	VB
particular	RB
specialist	NN
origin	NN
approval	NN
mine	NN
quietly	RB
advise	VB
conventional	JJ
drop	NN
count	NN
depth	NN
wealth	NN
disability	NN
shell	NN
general	RB
criticize	VB
fast	JJ
professional	NN
effectively	RB
biological	JJ
pack	NN
onion	NN
deputy	NN
flat	JJ
brand	NN
assure	VB
mad	JJ
award	NN
criteria	NN
dealer	NN
via	IN
alternative	JJ
utility	NN
precisely	RB
arise	VB
armed	JJ
nevertheless	RB
highway	NN
clinical	JJ
routine	NN
schedule	VB
wage	NN
normally	RB
phrase	NN
ingredient	NN
stake	NN
Muslim	JJ
dream	VB
fiber	NN
activist	NN
Islamic	JJ
snap	VB
terrorism	NN
refugee	NN
incorporate	VB
hip	NN
ultimate	JJ
switch	VB
corporation	NN
valuable	JJ
assumption	NN
gear	NN
graduate	VB
barrier	NN
minor	JJ
provision	NN
killer	NN
assign	VB
gang	NN
developing	JJ
classic	JJ
chemical	NN
wave	VB
label	NN
teen	NN
index	NN
vacation	NN
advocate	NN
draft	NN
extraordinary	JJ
heaven	NN
rough	JJ
yell	VB
pregnant	JJ
distant	JJ
drama	NN
satellite	NN
personally	RB
wonder	NN
clock	NN
chocolate	NN
Italian	JJ
Canadian	JJ
ceiling	NN
sweep	VB
advertising	NN
universal	JJ
spin	VB
house	VB
button	NN
bell	NN
rank	NN
darkness	NN
ahead	IN
clothing	NN
super	JJ
yield	VB
fence	NN
portrait	NN
paint	NN
survival	NN
roughly	RB
lawsuit	NN
bottom	JJ
testimony	NN
bunch	NN
beat	NN
wind	VB
found	VB
burden	NN
react	VB
chamber	NN
furniture	NN
cooperation	NN
string	NN
ceremony	NN
communicate	VB
taste	VB
cheek	NN
lost	JJ
profile	NN
mechanism	NN
disagree	VB
like	RB
penalty	NN
match	NN
ie	RB
advance	VB
resort	NN
destruction	NN
bear	NN
unlikely	JJ
tissue	NN
constitutional	JJ
pant	NN
stranger	NN
infection	NN
cabinet	NN
broken	JJ
apple	NN
electric	JJ
proceed	VB
track	VB
bet	VB
literary	JJ
virus	NN
stupid	JJ
dispute	NN
fortune	NN
strategic	JJ
assistant	NN
overcome	VB
remarkable	JJ
occupy	VB
statistics	NN
shopping	NN
cousin	NN
encounter	VB
wipe	VB
initially	RB
blind	JJ
white	NN
port	NN
honor	VB
electricity	NN
genetic	JJ
adviser	NN
pay	NN
spokesman	NN
retain	VB
latter	DT
incentive	NN
slave	NN
chemical	JJ
translate	VB
accurate	JJ
whereas	CC
terror	NN
though	RB
expansion	NN
elite	NN
Olympic	JJ
dirt	NN
odd	JJ
rice	NN
bullet	NN
tight	JJ
Bible	NN
chart	NN
solar	JJ
decline	NN
conservative	NN
process	VB
square	JJ
stick	NN
concentration	NN
complicated	JJ
gently	RB
champion	NN
scenario	NN
telescope	NN
reflection	NN
revolution	NN
strip	NN
interpret	VB
friendly	JJ
tournament	NN
fiction	NN
detect	VB
balance	VB
likely	RB
tremendous	JJ
lifetime	NN
recommendation	NN
flow	VB
senator	NN
market	VB
hunting	NN
salad	NN
guarantee	VB
innocent	JJ
boundary	NN
pause	VB
remote	JJ
satisfaction	NN
journal	NN
bench	NN
lover	NN
raw	JJ
awareness	NN
surprising	JJ
withdraw	VB
general	NN
deck	NN
similarly	RB
newly	RB
pole	NN
testify	VB
mode	NN
dialogue	NN
imply	VB
naturally	RB
mutual	JJ
founder	NN
top	IN
advanced	JJ
pride	NN
dismiss	VB
aircraft	NN
delivery	NN
mainly	RB
bake	VB
freeze	VB
platform	NN
finance	NN
sink	VB
attractive	JJ
respect	VB
diverse	JJ
relevant	JJ
ideal	JJ
joy	NN
worth	NN
regularly	RB
working	JJ
singer	NN
evolve	VB
shooting	NN
partly	RB
unknown	JJ
assistant	JJ
offense	NN
counter	NN
DNA	NN
smell	NN
potentially	RB
transfer	NN
thirty	CD
justify	VB
protest	NN
crash	NN
craft	NN
treaty	NN
terrorist	NN
insight	NN
possess	VB
politically	RB
tap	VB
lie	NN
extensive	JJ
episode	NN
double	VB
swim	VB
tire	VB
fault	NN
loose	JJ
free	VB
shortly	RB
originally	RB
considerable	JJ
prior	IN
intellectual	JJ
mix	NN
assault	NN
relax	VB
stair	NN
adventure	NN
external	JJ
proof	NN
confident	JJ
headquarters	NN
sudden	JJ
dirty	JJ
violation	NN
tongue	NN
license	NN
hold	NN
shelter	NN
rub	VB
controversy	NN
entrance	NN
favorite	NN
practice	VB
properly	RB
fade	VB
defensive	JJ
tragedy	NN
net	NN
characterize	VB
funeral	NN
profession	NN
alter	VB
spot	VB
constitute	VB
establishment	NN
squeeze	VB
imagination	NN
target	VB
mask	NN
convert	VB
comprehensive	JJ
prominent	JJ
presentation	NN
regardless	RB
easy	RB
load	VB
stable	JJ
introduction	NN
appeal	VB
pretend	VB
not	CC
elderly	JJ
representation	NN
deer	NN
split	VB
violate	VB
partnership	NN
pollution	NN
emission	NN
steady	JJ
vital	JJ
neither	DT
fate	NN
earnings	NN
oven	NN
distinction	NN
segment	NN
nowhere	RB
poet	NN
mere	JJ
exciting	JJ
variation	NN
comfort	NN
radical	JJ
stress	VB
adapt	VB
Irish	JJ
honey	NN
correspondent	NN
pale	JJ
musician	NN
significance	NN
load	NN
round	JJ
vessel	NN
storage	NN
flee	VB
mm-hmm	UH
leather	NN
distribute	VB
evolution	NN
ill	JJ
tribe	NN
shelf	NN
can	NN
grandfather	NN
lawn	NN
buyer	NN
dining	NN
wisdom	NN
council	NN
vulnerable	JJ
instance	NN
garlic	NN
capability	NN
poetry	NN
celebrity	NN
gradually	RB
stability	NN
doubt	VB
fantasy	NN
scared	JJ
guide	VB
plot	NN
framework	NN
gesture	NN
depending	IN
ongoing	JJ
psychology	NN
since	RB
counselor	NN
witness	VB
chapter	NN
fellow	NN
divorce	NN
owe	VB
pipe	NN
athletic	JJ
slight	JJ
math	NN
shade	NN
tail	NN
sustain	VB
mount	VB
obligation	NN
angle	NN
palm	NN
differ	VB
custom	NN
store	VB
economist	NN
fifteen	CD
soup	NN
celebration	NN
efficient	JJ
damage	VB
composition	NN
satisfy	VB
pile	NN
briefly	RB
carbon	NN
closer	JJ
consume	VB
scheme	NN
crack	NN
frequency	NN
tobacco	NN
survivor	NN
besides	RB
in	CC
psychologist	NN
wealthy	JJ
galaxy	NN
given	JJ
fund	VB
ski	NN
limitation	NN
OK	JJ
trace	VB
appointment	NN
preference	NN
meter	NN
explosion	NN
arrest	NN
publicly	RB
incredible	JJ
fighter	NN
rapid	JJ
admission	NN
hunter	NN
educate	VB
painful	JJ
friendship	NN
aide	NN
infant	NN
calculate	VB
fifty	CD
rid	VB
porch	NN
tendency	NN
uniform	NN
formation	NN
scholarship	NN
reservation	NN
efficiency	NN
waste	VB
qualify	VB
mall	NN
derive	VB
scandal	NN
PC	NN
helpful	JJ
impress	VB
heel	NN
resemble	VB
privacy	NN
fabric	NN
surprise	VB
contest	NN
proportion	NN
guideline	NN
rifle	NN
maintenance	NN
conviction	NN
trick	NN
organic	JJ
tent	NN
examination	NN
publisher	NN
strengthen	VB
French	NN
proposed	JJ
myth	NN
sophisticated	JJ
cow	NN
etc	RB
standing	NN
asleep	JJ
tennis	NN
nerve	NN
barrel	NN
bombing	NN
membership	NN
ratio	NN
menu	NN
purchase	NN
controversial	JJ
desperate	JJ
rate	VB
lifestyle	NN
humor	NN
loud	JJ
glove	NN
suspect	NN
sufficient	JJ
narrative	NN
photographer	NN
helicopter	NN
Catholic	NN
modest	JJ
provider	NN
delay	NN
agricultural	JJ
explode	VB
stroke	NN
scope	NN
punishment	NN
handful	NN
badly	RB
horizon	NN
curious	JJ
downtown	JJ
girlfriend	NN
prompt	VB
request	VB
cholesterol	NN
absorb	VB
adjustment	NN
taxpayer	NN
eager	JJ
principal	NN
detailed	JJ
motivation	NN
assignment	NN
restriction	NN
across	RB
Palestinian	NN
laboratory	NN
workshop	NN
differently	RB
auto	NN
romantic	JJ
cotton	NN
motor	NN
sue	VB
flavor	NN
overlook	VB
float	VB
undergo	VB
sequence	NN
demonstration	NN
jet	NN
orange	JJ
consumption	NN
assert	VB
blade	NN
temporary	JJ
medication	NN
print	VB
cabin	NN
bite	VB
relative	JJ
edition	NN
valley	NN
yours	PRP$
pitch	NN
pine	NN
brilliant	JJ
versus	IN
manufacturing	NN
risk	VB
Christian	NN
complex	NN
absolute	JJ
chef	NN
discrimination	NN
offensive	JJ
German	NN
suit	VB
boom	NN
register	VB
appoint	VB
heritage	NN
God	NN
terrorist	JJ
dominant	JJ
successfully	RB
shit	NN
lemon	NN
hungry	JJ
sense	VB
dry	VB
wander	VB
submit	VB
economics	NN
naked	JJ
anticipate	VB
nut	NN
legacy	NN
extension	NN
shrug	VB
fly	NN
battery	NN
arrival	NN
legitimate	JJ
orientation	NN
inflation	NN
cope	VB
flame	NN
cluster	NN
host	VB
wound	NN
dependent	JJ
shower	NN
institutional	JJ
depict	VB
operating	NN
flesh	NN
garage	NN
operator	NN
instructor	NN
collapse	VB
borrow	VB
furthermore	RB
comedy	NN
mortgage	NN
sanction	NN
civilian	JJ
twelve	CD
weekly	JJ
habitat	NN
grain	NN
brush	VB
consciousness	NN
devote	VB
crack	VB
measurement	NN
province	NN
ease	VB
seize	VB
ethics	NN
nomination	NN
permission	NN
wise	JJ
actress	NN
summit	NN
acid	NN
odds	NN
gifted	JJ
frustration	NN
medium	NN
function	VB
physically	RB
grant	NN
distinguish	VB
shore	NN
repeatedly	RB
lung	NN
firm	JJ
running	JJ
correct	VB
distinct	JJ
artistic	JJ
discourse	NN
basket	NN
ah	UH
fighting	NN
impressive	JJ
competitor	NN
ugly	JJ
worried	JJ
portray	VB
powder	NN
ghost	NN
persuade	VB
moderate	JJ
subsequent	JJ
continued	JJ
cookie	NN
carrier	NN
cooking	NN
frequent	JJ
ban	VB
swing	NN
orange	NN
awful	JJ
admire	VB
pet	NN
miracle	NN
exceed	VB
rhythm	NN
widespread	JJ
killing	NN
lovely	JJ
sin	NN
charity	NN
script	NN
tactic	NN
identification	NN
transformation	NN
everyday	JJ
headline	NN
crash	VB
venture	NN
invasion	NN
military	NN
nonetheless	RB
adequate	JJ
piano	NN
grocery	NN
intensity	NN
exhibit	VB
high	RB
blanket	NN
margin	NN
principal	JJ
quarterback	NN
mouse	NN
rope	NN
concrete	JJ
prescription	NN
African-American	JJ
chase	VB
document	VB
brick	NN
recruit	VB
patch	NN
consensus	NN
horror	NN
recording	NN
changing	JJ
painter	NN
colonial	JJ
pie	NN
sake	NN
gaze	NN
courage	NN
pregnancy	NN
swear	VB
defeat	VB
clue	NN
reinforce	VB
win	NN
confusion	NN
slice	NN
occupation	NN
dear	JJ
coal	NN
sacred	JJ
criminal	NN
formula	NN
cognitive	JJ
collective	JJ
exact	JJ
uncle	NN
square	NN
captain	NN
sigh	VB
attribute	VB
dare	VB
okay	JJ
homeless	JJ
cool	VB
gallery	NN
soccer	NN
defendant	NN
tunnel	NN
fitness	NN
lap	NN
grave	NN
toe	NN
container	NN
virtue	NN
abroad	RB
architect	NN
dramatically	RB
makeup	NN
inquiry	NN
rose	NN
surprisingly	RB
highlight	VB
decrease	VB
indication	NN
rail	NN
anniversary	NN
couch	NN
alliance	NN
hypothesis	NN
boyfriend	NN
compose	VB
peer	VB
mess	NN
rank	VB
legend	NN
regulate	VB
adolescent	NN
shine	VB
norm	NN
upset	VB
remark	NN
resign	VB
reward	NN
gentle	JJ
related	JJ
organ	NN
lightly	RB
concerning	IN
invent	VB
laughter	NN
fit	JJ
northwest	NN
counseling	NN
tight	RB
receiver	NN
ritual	NN
insect	NN
interrupt	VB
salmon	NN
favor	NN
trading	NN
concern	VB
magic	JJ
superior	JJ
combat	NN
stem	NN
surgeon	NN
acceptable	JJ
physics	NN
rape	NN
counsel	NN
brush	NN
jeans	NN
hunt	VB
continuous	JJ
log	NN
echo	VB
pill	NN
excited	JJ
sculpture	NN
compound	NN
integrate	VB
flour	NN
bitter	JJ
bare	JJ
slope	NN
rent	VB
presidency	NN
serving	NN
subtle	JJ
greatly	RB
bishop	NN
drinking	NN
delay	VB
cry	NN
acceptance	NN
collapse	NN
shop	VB
pump	NN
candy	NN
evil	NN
final	NN
finance	VB
pleased	JJ
medal	NN
beg	VB
sponsor	VB
ethical	JJ
secondary	JJ
slam	VB
export	NN
experimental	JJ
melt	VB
midnight	NN
net	JJ
curve	NN
integrity	NN
entitle	VB
evident	JJ
logic	NN
essence	NN
park	VB
exclude	VB
harsh	JJ
closet	NN
suburban	JJ
greet	VB
favor	IN
interior	NN
corridor	NN
murder	VB
retail	JJ
pitcher	NN
march	VB
snake	NN
pitch	VB
excuse	VB
cross	NN
weakness	NN
pig	NN
cold	NN
classical	JJ
estimated	JJ
T-shirt	NN
online	RB
unemployment	NN
civilization	NN
fold	VB
patient	JJ
pop	NN
daily	RB
reverse	VB
missing	JJ
correlation	NN
humanity	NN
flash	VB
developer	NN
reliable	JJ
excitement	NN
beef	NN
Islam	NN
Roman	JJ
stretch	NN
architecture	NN
occasional	JJ
administrative	JJ
elbow	NN
deadly	JJ
Muslim	NN
Hispanic	JJ
allegation	NN
tip	VB
confuse	VB
airplane	NN
monthly	JJ
duck	NN
dose	NN
Korean	JJ
plead	VB
initiate	VB
lecture	NN
van	NN
sixth	JJ
bay	NN
mainstream	JJ
suburb	NN
sandwich	NN
unlike	JJ
trunk	NN
rumor	NN
implementation	NN
swallow	VB
motivate	VB
render	VB
longtime	JJ
trap	VB
restrict	VB
cloth	NN
seemingly	RB
legislative	JJ
effectiveness	NN
enforce	VB
lens	NN
reach	NN
inspector	NN
lend	VB
plain	JJ
fraud	NN
companion	NN
contend	VB
nail	NN
array	NN
strict	JJ
assemble	VB
frankly	RB
rat	NN
burst	VB
hallway	NN
cave	NN
inevitable	JJ
southwest	NN
monster	NN
speed	VB
protest	VB
unexpected	JJ
obstacle	NN
facilitate	VB
encounter	NN
rip	VB
herb	NN
overwhelming	JJ
integration	NN
crystal	NN
recession	NN
wish	NN
top	VB
written	JJ
motive	NN
label	VB
flood	NN
pen	NN
ownership	NN
nightmare	NN
notice	NN
inspection	NN
supervisor	NN
consult	VB
arena	NN
laugh	NN
diagnosis	NN
possession	NN
forgive	VB
warm	VB
consistently	RB
basement	NN
project	VB
drift	VB
drain	VB
last	RB
prosecution	NN
maximum	JJ
announcement	NN
warrior	NN
prediction	NN
bacteria	NN
questionnaire	NN
mud	NN
infrastructure	NN
hurry	VB
privilege	NN
temple	NN
medium	JJ
outdoor	JJ
suck	VB
and/or	CC
broadcast	NN
re	IN
leap	VB
random	JJ
past	RB
wrist	NN
curtain	NN
monitor	NN
pond	NN
domain	NN
guilt	NN
cattle	NN
subject	IN
walking	NN
playoff	NN
minimum	JJ
fiscal	JJ
skirt	NN
dump	VB
hence	RB
database	NN
uncomfortable	JJ
aim	NN
execute	VB
limb	NN
ideology	NN
average	VB
welcome	JJ
tune	VB
continuing	JJ
harm	NN
railroad	NN
endure	VB
radiation	NN
horn	NN
chronic	JJ
peaceful	JJ
innovation	NN
strain	NN
guitar	NN
replacement	NN
behave	VB
administer	VB
simultaneously	RB
dancer	NN
amendment	NN
guard	VB
pad	NN
transmission	NN
await	VB
retired	JJ
trigger	VB
spill	VB
grateful	JJ
grace	NN
virtual	JJ
response	IN
colony	NN
adoption	NN
slide	NN
indigenous	JJ
closed	JJ
convict	VB
civilian	NN
towel	NN
modify	VB
particle	NN
award	VB
glance	NN
prize	NN
landing	NN
conduct	NN
blue	NN
boost	VB
bat	NN
alarm	NN
festival	NN
grip	NN
weird	JJ
undermine	VB
freshman	NN
sweat	NN
outer	JJ
European	NN
drunk	JJ
survey	VB
research	VB
separation	NN
traditionally	RB
stuff	VB
govern	VB
southeast	NN
intelligent	JJ
wherever	RB
ballot	NN
rhetoric	NN
convinced	JJ
driving	JJ
vitamin	NN
enthusiasm	NN
accommodate	VB
praise	VB
injure	VB
wilderness	NN
nearby	RB
endless	JJ
mandate	NN
pause	NN
excuse	NN
respectively	RB
uncertainty	NN
chaos	NN
short	RB
mechanical	JJ
canvas	NN
forty	CD
matter	DT
lobby	NN
profound	JJ
format	NN
trait	NN
currency	NN
turkey	NN
reserve	NN
beam	NN
abuse	VB
astronomer	NN
corruption	NN
contractor	NN
apologize	VB
doctrine	NN
genuine	JJ
thumb	NN
unity	NN
compromise	NN
horrible	JJ
behavioral	JJ
exclusive	JJ
scatter	VB
commonly	RB
convey	VB
rush	NN
twist	VB
complexity	NN
fork	NN
disk	NN
relieve	VB
suspicion	NN
lock	NN
finish	NN
residence	NN
shame	NN
meaningful	JJ
sidewalk	NN
Olympics	NN
technological	JJ
signature	NN
pleasant	JJ
wow	UH
suspend	VB
rebel	NN
frozen	JJ
desire	VB
spouse	NN
fluid	NN
pension	NN
resume	VB
theoretical	JJ
sodium	NN
blow	NN
promotion	NN
delicate	JJ
forehead	NN
rebuild	VB
bounce	VB
electrical	JJ
hook	NN
detective	NN
traveler	NN
click	VB
compensation	NN
signal	VB
exit	NN
attraction	NN
dedicate	VB
altogether	RB
pickup	NN
carve	VB
needle	NN
belly	NN
ship	VB
scare	VB
portfolio	NN
shuttle	NN
invisible	JJ
timing	NN
engagement	NN
ankle	NN
transaction	NN
rescue	VB
counterpart	NN
historically	RB
firmly	RB
mild	JJ
rider	NN
doll	NN
noon	NN
exhibit	NN
amid	IN
identical	JJ
precise	JJ
anxious	JJ
structural	JJ
residential	JJ
loud	RB
diagnose	VB
carbohydrate	NN
liberty	NN
poster	NN
theology	NN
nonprofit	JJ
crawl	VB
oxygen	NN
handsome	JJ
magic	NN
sum	NN
provided	CC
businessman	NN
promising	JJ
conscious	JJ
determination	NN
donor	NN
hers	PRP$
pastor	NN
jazz	NN
opera	NN
Japanese	NN
bite	NN
frame	VB
evil	JJ
acquisition	NN
pit	NN
hug	VB
wildlife	NN
punish	VB
giant	NN
primary	NN
equity	NN
wrong	RB
doorway	NN
departure	NN
elevator	NN
teenage	JJ
guidance	NN
happiness	NN
statue	NN
pursuit	NN
repair	NN
decent	JJ
gym	NN
oral	JJ
clerk	NN
Israeli	NN
envelope	NN
reporting	NN
destination	NN
fist	NN
endorse	VB
exploration	NN
generous	JJ
bath	NN
rescue	NN
thereby	RB
overall	RB
indicator	NN
sunlight	NN
feedback	NN
spectrum	NN
purple	JJ
laser	NN
bold	JJ
reluctant	JJ
starting	NN
expertise	NN
practically	RB
program	VB
picture	VB
tune	NN
eating	NN
age	VB
volunteer	VB
hint	NN
sharply	RB
parade	NN
advocate	VB
realm	NN
ban	NN
strip	VB
cancel	VB
blend	VB
therapist	NN
slice	VB
peel	VB
pizza	NN
recipient	NN
hesitate	VB
flip	VB
accounting	NN
debate	VB
bias	NN
huh	UH
metaphor	NN
candle	NN
handle	NN
worry	NN
judicial	JJ
entity	NN
suffering	NN
full-time	JJ
feel	NN
lamp	NN
garbage	NN
servant	NN
addition	NN
regulatory	JJ
diplomatic	JJ
elegant	JJ
inside	NN
reception	NN
vanish	VB
automatically	RB
chin	NN
trail	VB
necessity	NN
confess	VB
racism	NN
starter	NN
interior	JJ
banking	NN
casual	JJ
gravity	NN
enroll	VB
diminish	VB
prevention	NN
Arab	NN
value	VB
minimize	VB
chop	VB
performer	NN
intent	NN
isolate	VB
pump	VB
inventory	NN
productive	JJ
assembly	NN
civic	JJ
silk	NN
magnitude	NN
steep	JJ
hostage	NN
collector	NN
popularity	NN
kiss	NN
alien	NN
dynamic	JJ
scary	JJ
equation	NN
angel	NN
switch	NN
offering	NN
rage	NN
photography	NN
repair	VB
toilet	NN
disappointed	JJ
precious	JJ
prohibit	VB
representative	JJ
content	JJ
realistic	JJ
Russian	NN
hidden	JJ
command	VB
tender	JJ
wake	NN
gathering	NN
outstanding	JJ
stumble	VB
lonely	JJ
automobile	NN
artificial	JJ
dawn	NN
abstract	JJ
descend	VB
silly	JJ
hook	VB
tide	NN
shared	JJ
hopefully	RB
readily	RB
cooperate	VB
revolutionary	JJ
romance	NN
hardware	NN
pillow	NN
kit	NN
cook	NN
spread	NN
continent	NN
seal	VB
circuit	NN
sink	NN
ruling	NN
shortage	NN
annually	RB
lately	RB
trap	NN
scan	VB
fool	NN
deadline	NN
rear	JJ
processing	NN
ranch	NN
coastal	JJ
undertake	VB
softly	RB
reserve	VB
burning	JJ
verbal	JJ
tribal	JJ
ridiculous	JJ
automatic	JJ
diamond	NN
credibility	NN
import	NN
sexually	RB
spring	VB
way	RB
divine	JJ
sentiment	NN
cart	NN
oversee	VB
stem	VB
elder	NN
pro	NN
inspiration	NN
Dutch	JJ
quantity	NN
trailer	NN
mate	NN
o'clock	RB
Greek	JJ
genius	NN
monument	NN
bid	NN
quest	NN
sacrifice	NN
invitation	NN
accuracy	NN
juror	NN
officially	RB
broker	NN
treasure	NN
loyalty	NN
credit	VB
shock	VB
talented	JJ
gasoline	NN
stiff	JJ
output	NN
nominee	NN
extended	JJ
please	VB
diabetes	NN
slap	VB
toxic	JJ
alleged	JJ
jaw	NN
grief	NN
mysterious	JJ
rocket	NN
donate	VB
inmate	NN
tackle	VB
dynamics	NN
bow	NN
ours	PRP$
senior	NN
dignity	NN
carpet	NN
parental	JJ
bubble	NN
heat	VB
buddy	NN
barn	NN
sword	NN
flash	NN
seventh	JJ
glory	NN
tightly	RB
protective	JJ
tuck	VB
drum	NN
faint	JJ
post	VB
queen	NN
dilemma	NN
input	NN
specialize	VB
northeast	NN
shallow	JJ
liability	NN
sail	VB
merchant	NN
stadium	NN
improved	JJ
bloody	JJ
defeat	NN
associated	JJ
withdrawal	NN
refrigerator	NN
nest	NN
near	JJ
thoroughly	RB
lane	NN
ancestor	NN
condemn	VB
steam	NN
accent	NN
escape	NN
optimistic	JJ
unite	VB
cage	NN
equip	VB
shrimp	NN
homeland	NN
exchange	VB
rack	NN
costume	NN
wolf	NN
courtroom	NN
statute	NN
cartoon	NN
besides	IN
productivity	NN
grin	VB
symbolic	JJ
seal	NN
bug	NN
bless	VB
aunt	NN
agriculture	NN
rock	VB
hostile	JJ
root	VB
conceive	VB
combined	JJ
instantly	RB
bankruptcy	NN
vaccine	NN
bonus	NN
collaboration	NN
mixed	JJ
opposed	IN
orbit	NN
grasp	VB
patience	NN
spite	IN
tropical	JJ
voting	NN
patrol	NN
willingness	NN
position	VB
revelation	NN
rent	NN
calm	VB
jewelry	NN
Cuban	JJ
haul	VB
concede	VB
trace	NN
wagon	NN
afterward	RB
spectacular	JJ
ruin	VB
sheer	JJ
prior	JJ
immune	JJ
reliability	NN
ass	NN
alongside	IN
bush	NN
exotic	JJ
fascinating	JJ
secure	JJ
clip	NN
thigh	NN
bull	NN
drawer	NN
regard	IN
sheep	NN
discourage	VB
coordinator	NN
ideological	JJ
runner	NN
secular	JJ
intimate	JJ
empire	NN
cab	NN
divorce	VB
exam	NN
documentary	NN
neutral	JJ
biology	NN
flexible	JJ
progressive	JJ
web	NN
conspiracy	NN
catch	NN
casualty	NN
republic	NN
execution	NN
terrific	JJ
whale	NN
functional	JJ
star	VB
draft	VB
instinct	NN
teammate	NN
aluminum	NN
whoever	WP
ministry	NN
verdict	NN
instruct	VB
skull	NN
self-esteem	NN
ease	NN
cooperative	JJ
manipulate	VB
bee	NN
practitioner	NN
loop	NN
edit	VB
whip	VB
puzzle	NN
mushroom	NN
subsidy	NN
boil	VB
tragic	JJ
mathematics	NN
mechanic	NN
jar	NN
respect	IN
earthquake	NN
pork	NN
creativity	NN
safely	RB
underlying	JJ
dessert	NN
sympathy	NN
fisherman	NN
incredibly	RB
isolation	NN
sock	NN
near	RB
jump	NN
eleven	CD
sexy	JJ
entrepreneur	NN
syndrome	NN
bureau	NN
seat	VB
workplace	NN
ambition	NN
touchdown	NN
utilize	VB
breeze	NN
costly	JJ
ambitious	JJ
Christianity	NN
presumably	RB
influential	JJ
translation	NN
uncertain	JJ
dissolve	VB
object	VB
statistical	JJ
gut	NN
metropolitan	JJ
rolling	JJ
aesthetic	JJ
spell	VB
insert	VB
booth	NN
helmet	NN
waist	NN
expected	JJ
lion	NN
accomplishment	NN
royal	JJ
panic	NN
cast	NN
crush	VB
actively	RB
cliff	NN
minimal	JJ
cord	NN
fortunately	RB
cocaine	NN
illusion	NN
anonymous	JJ
tolerate	VB
appreciation	NN
commissioner	NN
harm	VB
flexibility	NN
instructional	JJ
scramble	VB
casino	NN
tumor	NN
decorate	VB
sort	VB
charge	IN
pulse	NN
equivalent	NN
fixed	JJ
experienced	JJ
donation	NN
diary	NN
sibling	NN
irony	NN
spoon	NN
midst	NN
alley	NN
upset	JJ
interact	VB
soap	NN
cute	JJ
rival	NN
short-term	JJ
punch	VB
pin	NN
hockey	NN
passing	JJ
persist	VB
supplier	NN
known	JJ
momentum	NN
purse	NN
shed	VB
liquid	NN
icon	NN
elephant	NN
consequently	RB
legislature	NN
associate	NN
franchise	NN
correctly	RB
mentally	RB
foster	VB
bicycle	NN
encouraging	JJ
cheat	VB
access	VB
heal	VB
fever	NN
filter	NN
rabbit	NN
coin	NN
exploit	VB
accessible	JJ
organism	NN
sensation	NN
partially	RB
stay	NN
upstairs	RB
dried	JJ
minimum	NN
pro	JJ
conservation	NN
shove	VB
backyard	NN
charter	NN
stove	NN
consent	NN
comprise	VB
reminder	NN
alike	RB
placement	NN
dough	NN
grandchild	NN
dam	NN
reportedly	RB
well-known	JJ
surrounding	JJ
ecological	JJ
outfit	NN
unprecedented	JJ
columnist	NN
workout	NN
preliminary	JJ
patent	NN
shy	JJ
quote	NN
trash	NN
disabled	JJ
gross	JJ
damn	JJ
hay	NN
texture	NN
counter	VB
pencil	NN
associate	JJ
frontier	NN
spray	NN
bet	NN
disclose	VB
custody	NN
banker	NN
beast	NN
interfere	VB
oak	NN
case	CC
eighth	JJ
notebook	NN
outline	VB
gaze	VB
attendance	NN
speculation	NN
uncover	VB
behalf	IN
innovative	JJ
shark	NN
reward	VB
mill	NN
installation	NN
stimulate	VB
tag	NN
vertical	JJ
swimming	NN
fleet	NN
catalog	NN
outsider	NN
sacrifice	VB
desperately	RB
stance	NN
compel	VB
sensitivity	NN
someday	RB
instant	JJ
debut	NN
proclaim	VB
worldwide	RB
hike	VB
required	JJ
confrontation	NN
colorful	JJ
ideal	NN
constitution	NN
trainer	NN
Thanksgiving	NN
scent	NN
stack	NN
eyebrow	NN
sack	NN
cease	VB
inherit	VB
tray	NN
pioneer	NN
organizational	JJ
textbook	NN
uh	UH
nasty	JJ
shrink	VB
model	VB
emerging	JJ
dot	NN
wheat	NN
fierce	JJ
envision	VB
rational	JJ
kingdom	NN
aisle	NN
weaken	VB
protocol	NN
exclusively	RB
vocal	JJ
marketplace	NN
openly	RB
unfair	JJ
terrain	NN
deploy	VB
risky	JJ
pasta	NN
genre	NN
distract	VB
merit	NN
planner	NN
depressed	JJ
chunk	NN
closest	JJ
discount	NN
no	DT
ladder	NN
jungle	NN
migration	NN
breathing	NN
invade	VB
hurricane	NN
retailer	NN
classify	VB
wound	VB
coup	NN
aid	VB
ambassador	NN
density	NN
supportive	JJ
curiosity	NN
skip	VB
aggression	NN
stimulus	NN
journalism	NN
robot	NN
flood	VB
dip	VB
likewise	RB
informal	JJ
Persian	JJ
feather	NN
sphere	NN
tighten	VB
boast	VB
pat	VB
perceived	JJ
sole	JJ
publicity	NN
major	NN
unfold	VB
joke	VB
well-being	NN
validity	NN
ecosystem	NN
strictly	RB
partial	JJ
collar	NN
weed	NN
compliance	NN
streak	NN
supposedly	RB
added	JJ
builder	NN
glimpse	NN
premise	NN
specialty	NN
deem	VB
artifact	NN
sneak	VB
monkey	NN
mentor	NN
two-thirds	CD
listener	NN
lightning	NN
legally	RB
sleeve	NN
disappointment	NN
disturb	VB
rib	NN
excessive	JJ
high-tech	JJ
debris	NN
pile	VB
rod	NN
logical	JJ
liberal	NN
ash	NN
socially	RB
parish	NN
slavery	NN
blank	JJ
commodity	NN
cure	NN
mineral	NN
hunger	NN
dying	JJ
developmental	JJ
faster	JJ
spare	VB
halfway	RB
cure	VB
equality	NN
cemetery	NN
harassment	NN
deliberately	RB
fame	NN
regret	VB
striking	JJ
likelihood	NN
carrot	NN
atop	IN
toll	NN
rim	NN
embarrassed	JJ
fucking	JJ
cling	VB
isolated	JJ
blink	VB
suspicious	JJ
wheelchair	NN
squad	NN
eligible	JJ
processor	NN
plunge	VB
this	RB
sponsor	NN
grin	NN
color	VB
demographic	JJ
rain	VB
chill	NN
refuge	NN
steer	VB
legislator	NN
rally	NN
programming	NN
cheer	VB
outlet	NN
intact	JJ
vendor	NN
thrive	VB
peanut	NN
chew	VB
elaborate	JJ
intellectual	NN
conception	NN
auction	NN
steak	NN
comply	VB
triumph	NN
shareholder	NN
comparable	JJ
transport	VB
conscience	NN
calculation	NN
considerably	RB
interval	NN
scratch	VB
awake	JJ
jurisdiction	NN
inevitably	RB
feminist	JJ
constraint	NN
emotionally	RB
expedition	NN
allegedly	RB
compromise	VB
strain	VB
similarity	NN
butt	NN
lid	NN
dumb	JJ
bulk	NN
sprinkle	VB
mortality	NN
philosophical	JJ
conversion	NN
patron	NN
municipal	JJ
any	RB
liver	NN
harmony	NN
solely	RB
tolerance	NN
instant	NN
goat	NN
arm	VB
blessing	NN
banana	NN
running	NN
palace	NN
formerly	RB
peasant	NN
neat	JJ
grandparent	NN
lawmaker	NN
supermarket	NN
cruise	NN
mobile	JJ
plain	NN
part	IN
calendar	NN
widow	NN
deposit	NN
beard	NN
brake	NN
downtown	RB
screening	NN
impulse	NN
forbid	VB
fur	NN
brutal	JJ
predator	NN
poke	VB
opt	VB
voluntary	JJ
trouble	VB
valid	JJ
forum	NN
dancing	NN
happily	RB
soar	VB
removal	NN
autonomy	NN
enact	VB
round	VB
thread	NN
light	IN
landmark	NN
unhappy	JJ
offender	NN
coming	JJ
privately	RB
fraction	NN
distinctive	JJ
tourism	NN
threshold	NN
calm	JJ
routinely	RB
suite	NN
remark	VB
regulator	NN
straw	NN
theological	JJ
apart	IN
exhaust	VB
globe	NN
fragile	JJ
objection	NN
chemistry	NN
old-fashioned	JJ
crowded	JJ
circle	VB
blast	NN
prevail	VB
overnight	RB
denial	NN
rental	NN
fantastic	JJ
fragment	NN
level	JJ
screw	VB
warmth	NN
undergraduate	NN
liquid	JJ
headache	NN
policeman	NN
yield	NN
projection	NN
battle	VB
suitable	JJ
mention	NN
graduation	NN
drill	VB
cruel	JJ
mansion	NN
regard	NN
grape	NN
authorize	VB
cottage	NN
driveway	NN
charm	NN
sexuality	NN
loyal	JJ
clay	NN
pound	VB
balloon	NN
invention	NN
ego	NN
fare	NN
homework	NN
disc	NN
sofa	NN
guarantee	NN
availability	NN
radar	NN
frown	VB
regain	VB
leave	NN
permit	NN
sweater	NN
rehabilitation	NN
rubber	JJ
retreat	NN
molecule	NN
freely	RB
favorable	JJ
steadily	RB
veteran	JJ
integrated	JJ
ha	UH
youngster	NN
broadcast	VB
premium	NN
accountability	NN
overwhelm	VB
one-third	CD
contemplate	VB
update	VB
spark	VB
ironically	RB
fatigue	NN
beyond	RB
speculate	VB
marker	NN
low	RB
preach	VB
bucket	NN
bomb	VB
blond	JJ
confession	NN
provoke	VB
marble	NN
substantially	RB
twist	NN
defender	NN
fish	VB
explicit	JJ
transport	NN
disturbing	JJ
surveillance	NN
magnetic	JJ
technician	NN
mutter	VB
devastating	JJ
depart	VB
arrow	NN
trauma	NN
neighboring	JJ
soak	VB
ribbon	NN
meantime	NN
transmit	VB
screen	VB
harvest	NN
consecutive	JJ
republican	JJ
coordinate	VB
worldwide	JJ
within	RB
spy	NN
slot	NN
riot	NN
nutrient	NN
citizenship	NN
severely	RB
sovereignty	NN
ridge	NN
brave	JJ
lighting	NN
specify	VB
contributor	NN
frustrate	VB
crowd	VB
articulate	VB
importantly	RB
transit	NN
dense	JJ
seminar	NN
electronics	NN
sunny	JJ
shorts	NN
swell	VB
accusation	NN
soften	VB
photograph	VB
straighten	VB
terribly	RB
cue	NN
sudden	RB
bride	NN
biography	NN
hazard	NN
compelling	JJ
seldom	RB
tile	NN
economically	RB
honestly	RB
troubled	JJ
bow	VB
twentieth	JJ
balanced	JJ
foreigner	NN
launch	NN
convenience	NN
delight	NN
weave	VB
timber	NN
till	CC
accurately	RB
plea	NN
bulb	NN
copy	VB
flying	JJ
sustainable	JJ
devil	NN
bolt	NN
cargo	NN
spine	NN
seller	NN
skilled	JJ
managing	JJ
public	RB
marine	JJ
dock	NN
organized	JJ
fog	NN
diplomat	NN
boring	JJ
sometime	RB
summary	NN
missionary	NN
epidemic	NN
fatal	JJ
trim	VB
warehouse	NN
accelerate	VB
butterfly	NN
bronze	NN
drown	VB
inherent	JJ
praise	NN
nationwide	RB
spit	VB
harvest	VB
kneel	VB
vacuum	NN
selected	JJ
dictate	VB
stereotype	NN
sensor	NN
laundry	NN
manual	NN
pistol	NN
naval	JJ
plaintiff	NN
kid	VB
middle-class	JJ
apology	NN
till	IN